a	a
abad	a b a d
abadesa	a b a d e s a
abadía	a b a d i a
abajo	a b a x o
abalorio	a b a l o 4 j o
abanderada	a b a n d e 4 a d a
abanderado	a b a n d e 4 a d o
abanderamiento	a b a n d e 4 a m j e n t o
abanderar	a b a n d e 4 a 4
abandonado	a b a n d o n a d o
abandonar	a b a n d o n a 4
abandono	a b a n d o n o
abanico	a b a n i k o
abaratar	a b a 4 a t a 4
abarca	a b a r k a
abarcar	a b a r k a 4
abarrotado	a b a r o t a d o
abarrotar	a b a r o t a 4
abastecedor	a b a s t e T e d o 4
abastecer	a b a s t e T e 4
abastecimiento	a b a s t e T i m j e n t o
abasto	a b a s t o
abatible	a b a t i b l e
abatido	a b a t i d o
abatimiento	a b a t i m j e n t o
abatir	a b a t i 4
abdicación	a b d i k a T j o n
abdicar	a b d i k a 4
abdomen	a b d o m e n
abdominal	a b d o m i n a l
abducir	a b d u T i 4
abecedario	a b e T e d a 4 j o
abeja	a b e x a
abejón	a b e x o n
aberración	a b e r a T j o n
aberrante	a b e r a n t e
abertura	a b e r t u 4 a
abeto	a b e t o
abierto	a b j e r t o
abisal	a b i s a l
abismal	a b i s m a l
abismo	a b i s m o
ablandamiento	a b l a n d a m j e n t o
ablandar	a b l a n d a 4
abnegación	a b n e g a T j o n
abocado	a b o k a d o
abochornado	a b o tS o r n a d o
abogacía	a b o g a T i a
abogada	a b o g a d a
abogado	a b o g a d o
abogar	a b o g a 4
abolicionista	a b o l i T j o n i s t a
abolición	a b o l i T j o n
abolir	a b o l i 4
abolladura	a b o L a d u 4 a
abominable	a b o m i n a b l e
abominación	a b o m i n a T j o n
abonado	a b o n a d o
abonar	a b o n a 4
abono	a b o n o
abordaje	a b o r d a x e
abordar	a b o r d a 4
abordo	a b o r d o
aborigen	a b o 4 i x e n
aborrecible	a b o r e T i b l e
abortar	a b o r t a 4
abortista	a b o r t i s t a
aborto	a b o r t o
abra	a b 4 a
abrasador	a b 4 a s a d o 4
abrasivo	a b 4 a s i b o
abrazadera	a b 4 a T a d e 4 a
abrazar	a b 4 a T a 4
abrazo	a b 4 a T o
abre	a b 4 e
abreviación	a b 4 e b j a T j o n
abreviado	a b 4 e b j a d o
abreviatura	a b 4 e b j a t u 4 a
abridor	a b 4 i d o 4
abrigar	a b 4 i g a 4
abrigarse	a b 4 i g a r s e
abrigo	a b 4 i g o
abril	a b 4 i l
abrir	a b 4 i 4
abrirse	a b 4 i r s e
abrochar	a b 4 o tS a 4
abrocharse	a b 4 o tS a r s e
abrumado	a b 4 u m a d o
abrumador	a b 4 u m a d o 4
abrumar	a b 4 u m a 4
absentismo	a b s e n t i s m o
absolución	a b s o l u T j o n
absolutismo	a b s o l u t i s m o
absoluto	a b s o l u t o
absolutorio	a b s o l u t o 4 j o
absolver	a b s o l b e 4
absorbente	a b s o r b e n t e
absorber	a b s o r b e 4
absorción	a b s o 4 T j o n
absorto	a b s o r t o
abstemio	a b s t e m j o
abstencionismo	a b s t e n T j o n i s m o
abstención	a b s t e n T j o n
abstenerse	a b s t e n e r s e
abstenga	a b s t e n g a
abstiene	a b s t j e n e
abstinencia	a b s t i n e n T j a
abstracción	a b s t 4 a g T j o n
abstracto	a b s t 4 a g t o
abstraer	a b s t 4 a e 4
absurdo	a b s u r d o
abuela	a b w e l a
abuelita	a b w e l i t a
abuelito	a b w e l i t o
abuelo	a b u e l o
abultar	a b u l t a 4
abundado	a b u n d a d o
abundancia	a b u n d a n T j a
abundante	a b u n d a n t e
abundar	a b u n d a 4
aburrido	a b u r i d o
aburrimiento	a b u r i m j e n t o
aburrir	a b u r i 4
aburrirse	a b u r i r s e
abusador	a b u s a d o 4
abusar	a b u s a 4
abusivo	a b u s i b o
abuso	a b u s o
acabado	a k a b a d o
acabar	a k a b a 4
acabarse	a k a b a r s e
acabose	a k a b o s e
academia	a k a d e m j a
académico	a k a d e m i k o
acallar	a k a L a 4
acalorado	a k a l o 4 a d o
acampada	a k a m p a d a
acampar	a k a m p a 4
acantilado	a k a n t i l a d o
acaparar	a k a p a 4 a 4
acariciar	a k a 4 i T j a 4
acarrear	a k a r e a 4
acaso	a k a s o
acatamiento	a k a t a m j e n t o
acatar	a k a t a 4
acaudalado	a k a u d a l a d o
acceder	a g T e d e 4
accesibilidad	a g T e s i b i l i d a d
accesible	a g T e s i b l e
acceso	a g T e s o
accesorio	a g T e s o 4 j o
accidentado	a g T i d e n t a d o
accidental	a g T i d e n t a l
accidente	a g T i d e n t e
accionamiento	a g T j o n a m j e n t o
accionar	a g T j o n a 4
accionariado	a g T j o n a 4 j a d o
accionario	a g T j o n a 4 j o
accionista	a g T j o n i s t a
acción	a g T j o n
acecho	a T e tS o
aceite	a T e i t e
aceitoso	a T e i t o s o
aceituna	a T e i t u n a
aceleración	a T e l e 4 a T j o n
acelerador	a T e l e 4 a d o 4
acelerar	a T e l e 4 a 4
acelerómetro	a T e l e 4 o m e t 4 o
acelerón	a T e l e 4 o n
acento	a T e n t o
acentuar	a T e n t w a 4
acepción	a T e b T j o n
aceptable	a T e b t a b l e
aceptación	a T e b t a T j o n
aceptar	a T e b t a 4
acequia	a T e k j a
acera	a T e 4 a
acerca	a T e r k a
acercamiento	a T e r k a m j e n t o
acercar	a T e r k a 4
acercarse	a T e r k a r s e
acerico	a T e 4 i k o
acero	a d s e 4 o
acertante	a T e r t a n t e
acertar	a T e r t a 4
acertijo	a T e r t i x o
acetato	a T e t a t o
acetona	a T e t o n a
achacar	a tS a k a 4
achantar	a tS a n t a 4
achaque	a tS a k e
achuchar	a tS u tS a 4
aciago	a T j a g o
acicalar	a T i k a l a 4
acicate	a T i k a t e
acidez	a T i d e T
acidificación	a T i d i f i k a T j o n
acientífico	a T j e n t i f i k o
acierto	a T j e r t o
acimut	a T i m u t
aclamación	a k l a m a T j o n
aclaración	a k l a 4 a T j o n
aclarado	a k l a 4 a d o
aclarar	a k l a 4 a 4
acné	a k n e
acogedor	a k o x e d o 4
acoger	a k o x e 4
acogida	a k o x i d a
acojonante	a k o x o n a n t e
acojonar	a k o x o n a 4
acolchado	a k o l tS a d o
acolchar	a k o l tS a 4
acometer	a k o m e t e 4
acomodación	a k o m o d a T j o n
acomodado	a k o m o d a d o
acomodar	a k o m o d a 4
acomodo	a k o m o d o
acompañada	a k o m p a J a d a
acompañamiento	a k o m p a J a m j e n t o
acompañante	a k o m p a J a n t e
acompañar	a k o m p a J a 4
acomplejado	a k o m p l e x a d o
acondicionador	a k o n d i T j o n a d o 4
acondicionamiento	a k o n d i T j o n a m j e n t o
acondicionar	a k o n d i T j o n a 4
acongojado	a k o n g o x a d o
aconsejable	a k o n s e x a b l e
aconsejar	a k o n s e x a 4
acontecer	a k o n t e T e 4
acontecimiento	a k o n t e T i m j e n t o
acopiar	a k o p j a 4
acopio	a k o p j o
acoplado	a k o p l a d o
acoplamiento	a k o p l a m j e n t o
acoplar	a k o p l a 4
acoquinar	a k o k i n a 4
acorazado	a k o 4 a T a d o
acordado	a k o r d a d o
acordar	a k o r d a 4
acorde	a k o r d e
acordeonista	a k o r d e o n i s t a
acordeón	a k o r d e o n
acordándose	a k o 4 D a n d o s e
acorralar	a k o r a l a 4
acortar	a k o r t a 4
acortarse	a k o r t a r s e
acosar	a k o s a 4
acoso	a k o s o
acostado	a k o s t a d o
acostar	a k o s t a 4
acostumbrado	a k o s t u m b 4 a d o
acostumbrar	a k o s t u m b 4 a 4
acotación	a k o t a T j o n
acotado	a k o t a d o
acotamiento	a k o t a m j e n t o
acotar	a k o t a 4
acrecentar	a k 4 e T e n t a 4
acreditación	a k 4 e d i t a T j o n
acreditado	a k 4 e d i t a d o
acreditar	a k 4 e d i t a 4
acreditativo	a k 4 e d i t a t i b o
acreedor	a k 4 e e d o 4
acristalar	a k 4 i s t a l a 4
acritud	a k 4 i t u d
acrobacia	a k 4 o b a T j a
acrobático	a k 4 o b a t i k o
acrobáticos	a k 4 o B a t i k o s
acrílico	a k 4 i l i k o
acrónimo	a k 4 o n i m o
acrópolis	a k 4 o p o l i s
acta	a g t a
actitud	a g t i t u d
activación	a g t i b a T j o n
activar	a g t i b a 4
actividad	a g t i b i d a d
activismo	a g t i b i s m o
activista	a g t i b i s t a
activo	a g t i b o
acto	a g t o
actor	a g t o 4
actoral	a g t o 4 a l
actriz	a g t 4 i T
actuación	a g t w a T j o n
actual	a g t w a l
actualidad	a g t w a l i d a d
actualización	a g t w a l i T a T j o n
actualizar	a g t w a l i T a 4
actuante	a g t w a n t e
actuar	a g t w a 4
acuarela	a k w a 4 e l a
acuario	a k w a 4 j o
acuchillamiento	a k u tS i L a m j e n t o
acuchillar	a k u tS i L a 4
acuciante	a k u T j a n t e
acudir	a k u d i 4
acueducto	a k w e d u g t o
acuerdo	a k w e r d o
acullá	a k u L a
aculturación	a k u l t u 4 a T j o n
acumulable	a k u m u l a b l e
acumulación	a k u m u l a T j o n
acumulador	a k u m u l a d o 4
acumular	a k u m u l a 4
acumulativo	a k u m u l a t i b o
acusación	a k u s a T j o n
acusado	a k u s a d o
acusador	a k u s a d o 4
acusar	a k u s a 4
acuático	a k w a t i k o
acuífero	a k w i f e 4 o
acuñar	a k u J a 4
acá	a k a
acápite	a k a p i t e
acérrimo	a T e r i m o
acólito	a k o l i t o
acústica	a k u s t i k a
acústico	a k u s t i k o
adagio	a d a x j o
adaptabilidad	a d a b t a b i l i d a d
adaptable	a d a b t a b l e
adaptación	a d a b t a T j o n
adaptador	a d a b t a d o 4
adaptar	a d a b t a 4
adaptativo	a d a b t a t i b o
adecentar	a d e T e n t a 4
adeco	a d e k o
adecuación	a d e k w a T j o n
adecuado	a d e k w a d o
adecuar	a d e k w a 4
adefesio	a d e f e s j o
adelantado	a d e l a n t a d o
adelantamiento	a d e l a n t a m j e n t o
adelantar	a d e l a n t a 4
adelante	a d e l a n t e
adelanto	a d e l a n t o
adelgazamiento	a d e l g a T a m j e n t o
adelgazar	a d e l g a T a 4
además	a d e m a s
adentrar	a d e n t 4 a 4
adentrarse	a d e n t 4 a r s e
adentro	a d e n t 4 o
aderezado	a d e 4 e T a d o
aderezo	a d e 4 e T o
adeudar	a d e u d a 4
adeudo	a d e u d o
adherencia	a d e 4 e n T j a
adherente	a d e 4 e n t e
adherir	a d e 4 i 4
adherirse	a d e 4 i r s e
adhesivo	a d e s i b o
adhesión	a d e s j o n
adicción	a d i g T j o n
adicional	a d i T j o n a l
adición	a d i T j o n
adictivo	a d i g t i b o
adicto	a d i g t o
adiestramiento	a d j e s t 4 a m j e n t o
adiestrar	a d j e s t 4 a 4
adimensional	a d i m e n s j o n a l
adinerada	a d i n e 4 a d a
adineradas	a d i n e 4 a d a s
adinerado	a d i n e 4 a d o
adinerados	a d i n e 4 a d o s
aditamento	a d i t a m e n t o
aditivo	a d i t i b o
adivina	a d i b i n a
adivinación	a d i b i n a T j o n
adivinanza	a d i b i n a n T a
adivinar	a d i b i n a 4
adivino	a d i b i n o
adiós	a d j o s
adjetivo	a d x e t i b o
adjudicación	a d x u d i k a T j o n
adjudicar	a d x u d i k a 4
adjudicatario	a d x u d i k a t a 4 j o
adjuntar	a d x u n t a 4
adjunto	a d x u n t o
administración	a d m i n i s t 4 a T j o n
administrador	a d m i n i s t 4 a d o 4
administrar	a d m i n i s t 4 a 4
administrativo	a d m i n i s t 4 a t i b o
admirable	a d m i 4 a b l e
admiración	a d m i 4 a T j o n
admirador	a d m i 4 a d o 4
admirar	a d m i 4 a 4
admisibilidad	a d m i s i b i l i d a d
admisible	a d m i s i b l e
admisión	a d m i s j o n
admitir	a d m i t i 4
adobe	a d o b e
adobo	a d o b o
adoctrinamiento	a d o g t 4 i n a m j e n t o
adoctrinar	a d o g t 4 i n a 4
adolescencia	a d o l e s T e n T j a
adolescente	a d o l e s T e n t e
adolorido	a d o l o 4 i d o
adonde	a d o n d e
adopción	a d o b T j o n
adoptado	a d o b t a d o
adoptar	a d o b t a 4
adoptivo	a d o b t i b o
adorable	a d o 4 a b l e
adoración	a d o 4 a T j o n
adorador	a d o 4 a d o 4
adorar	a d o 4 a 4
adormecer	a d o r m e T e 4
adornar	a d o r n a 4
adosada	a d o s a d a
adosado	a d o s a d o
adquirir	a d k i 4 i 4
adquisición	a d k i s i T j o n
adquisitivo	a d k i s i t i b o
adrede	a d 4 e d e
adrenalina	a d 4 e n a l i n a
adriático	a d 4 j a t i k o
adscripción	a d s k 4 i b T j o n
aduana	a d w a n a
aduanal	a d w a n a l
aduanero	a d w a n e 4 o
aducir	a d u T i 4
aductor	a d u g t o 4
adueñarse	a d w e J a r s e
adulta	a d u l t a
adulteración	a d u l t e 4 a T j o n
adulterar	a d u l t e 4 a 4
adulterio	a d u l t e 4 j o
adultez	a d u l t e T
adulto	a d u l t o
adusto	a d u s t o
advenimiento	a d b e n i m j e n t o
adversaria	a d b e r s a 4 j a
adversarias	a d b e r s a 4 j a s
adversario	a d b e r s a 4 j o
adversidad	a d b e r s i d a d
advertencia	a d b e r t e n T j a
advertir	a d b e r t i 4
adyacente	a d J\j\ a T e n t e
adónde	a d o n d e
adúltero	a d u l t e 4 o
aedo	a e d o
aerobio	a e 4 o b j o
aeronaval	a e 4 o n a b a l
aeropuerto	a e 4 o p w e r t o
aerosol	a e 4 o s o l
aerostato	a e 4 o s t a t o
aeróbico	a e 4 o b i k o
aeródromo	a e 4 o d 4 o m o
aes	a e s
afable	a f a b l e
afamada	a f a m a d a
afamado	a f a m a d o
afar	a f a 4
afección	a f e g T j o n
afectación	a f e g t a T j o n
afectado	a f e g t a d o
afectar	a f e g t a 4
afectiva	a f e g t i b a
afectividad	a f e g t i b i d a d
afectivo	a f e g t i b o
afecto	a f e g t o
afeitada	a f e i t a d a
afeitado	a f e i t a d o
afeitar	a f e i t a 4
afeitarse	a f e i t a r s e
aferrar	a f e r a 4
aferrarse	a f e r a r s e
afianzamiento	a f j a n T a m j e n t o
afianzar	a f j a n T a 4
afiche	a f i tS e
aficionado	a f i T j o n a d o
afición	a f i T j o n
afilado	a f i l a d o
afilador	a f i l a d o 4
afilar	a f i l a 4
afiliación	a f i l j a T j o n
afiliada	a f i l j a d a
afiliado	a f i l j a d o
afinador	a f i n a d o 4
afinamiento	a f i n a m j e n t o
afinar	a f i n a 4
afincar	a f i n k a 4
afinidad	a f i n i d a d
afirmación	a f i r m a T j o n
afirmar	a f i r m a 4
afirmativo	a f i r m a t i b o
afluente	a f l u e n t e
aforo	a f o 4 o
afortunado	a f o r t u n a d o
afrenta	a f 4 e n t a
africano	a f 4 i k a n o
afro	a f 4 o
afrodisíaco	a f 4 o d i s i a k o
afrontar	a f 4 o n t a 4
afrutado	a f 4 u t a d o
afán	a f a n
afín	a f i n
afónico	a f o n i k o
agachar	a g a tS a 4
agacharse	a G a t S a 4 s e
agenda	a x e n d a
agendar	a x e n d a 4
agitarse	a x i t a r s e
agora	a g o 4 a
agosto	a g o s t o
agradable	a g 4 a d a b l e
agregar	a G 4 e G a 4
agrietarse	a g 4 j e t a r s e
agrupar	a g 4 u p a 4
agruparse	a g 4 u p a r s e
agua	a g w a
aguacate	a w a k a t e
aguacero	a g w a T e 4 o
aguador	a g w a d o 4
aguantar	a g w a n t a 4
aguante	a G w a n t e
aguda	a g u d a
aguja	a G u x a
agujero	a g u x e 4 o
agur	a g u 4
agüero	a g w e 4 o
ah	a
ahijado	a i x a d o
ahora	a o 4 a
ahorita	a o 4 i t a
ahí	a i
ahínco	a i N k o
aire	a i 4 e
aislacionista	a i s l a T j o n i s t a
ajedrez	a x e D 4 e T
ajeno	a x e n o
ajillo	a x i L o
ajo	a x o
ajustarse	a x u s t a r s e
al	a l
ala	a l a
alambre	a l a m b r e
alargar	a l a r g a 4
alas	a l a s
albañil	a l b a J i l
albedrío	a l b e d r i o
alboradas	a l b o 4 a d a s
albur	a l b u 4
alcalde	a l k a l d e
alcanfor	a l k a n f o 4
alcanzar	a l k a n T a 4
alcoba	a l k o b a
alcohol	a l k o o l
alcohólico	a l k o o l i k o
alcornoque	a l k o 4 n o k e
alcurnia	a l k u 4 n j a
alcázar	a l k a T a 4
alegoría	a l e g o 4 i a
alegría	a l e g 4 i a
alejamiento	a l e x a m j e n t o
aleje	a l e x e
alemana	a l e m a n a
alemanas	a l e m a n a s
alemanes	a l e m a n e s
alemán	a l e m a n
alergia	a l e r x j a
alero	a l e 4 o
aleta	a l e t a
alfa	a l f a
alfabético	a l f a b e t i k o
alfajor	a l f a x o 4
alfalfa	a l f a l f a
alfarero	a l f a 4 e 4 o
alga	a l g a
algar	a l g a 4
algo	a l g o
algoritmo	a l g o 4 i t m o
alguacil	a l g w a T i l
alguien	a l g j e n
algún	a l g u n
aliarse	a l j a r s e
aliento	a l j e n t o
aliviar	a l i b j a 4
allanamiento	a Z a n a m j e n t o
allá	a L a
allí	a L i
alma	a l m a
almacén	a l m a T e n
almeja	a l m e x a
almendra	a l m e n d 4 a
almizcle	a l m i T k l e
almohada	a l m o a d a
almorzar	a l m o 4 T a 4
almuerzo	a l m w e r T o
alondra	a l o n d 4 a
alrededor	a l r e D e D o 4
alta	a l t a
alto	a l t o
alubia	a l u b i a
alumbrar	a l u m b 4 a 4
alumbre	a l u m B 4 e
alunizaje	a l u n i s a x e
alzamiento	a l T a m j e n t o
alzar	a l T a 4
ama	a m a
amalgama	a m a l g a m a
amapola	a m a p o l a
amar	a m a 4
amargo	a m a 4 G o
amarillo	a m a 4 i L o
amarse	a m a r s e
amatista	a m a t i s t a
americano	a m e 4 i k a n o
amerizaje	a m e 4 i T a x e
amiga	a m i g a
amigo	a m i g o
amigote	a m i G o t e
amistad	a m i s t a D
amnesia	a m n e s j a
amo	a m o
amonestación	a m o n e s t a T j o n
amor	a m o 4
amparo	a m p a 4 o
amperio	a m p e 4 j o
ampolla	a m p o L a
anagrama	a n a g 4 a m a
analogía	a n a l o x i a
anaranjado	a n a 4 a n x a d o
anarquismo	a n a 4 k i s m o
anarquía	a n a r k i a
anatomía	a n a t o m i a
anatómico	a n a t o m i k o
ancestral	a n T e s t 4 a l
ancestro	a n T e s t 4 o
ancho	a J t S o
anchoa	a n tS o a
ancla	a N k l a
andar	a n d a 4
anestesia	a n e s t e s j a
anexar	a n e k s a 4
anfibio	a n f i b j o
anfiteatro	a n f i t e a t 4 o
angloparlante	a n g l o p a r l a n t e
anillo	a n i L o
animarse	a n i m a r s e
animo	a n i m o
animé	a n i m e
animó	a n i m o
anoche	a n o tS e
anochecer	a n o t S e T e 4
anonimato	a n o n i m a t o
anonimidad	a n o n i m i d a d
ansiedad	a n s j e d a d
antagónico	a n t a g o n i k o
antaño	a n t a J o
anterior	a n t e 4 j o 4
antes	a n t e s
antibalas	a n t i b a l a s
anticipar	a n t i T i p a 4
antiguo	a n t i g w o
antimisil	a n t i m i s i l
antimotines	a n t i m o t i n e s
antipático	a n t i p a t i k o
antojar	a_~ n t o x a 4
antonomasia	a n t o n o m a s j a
antorcha	a n t o r tS a
antro	a n t 4 o
antropología	a n t 4 o p o l o x i a
antropóloga	a n t 4 o p o l o g a
antropólogo	a n t 4 o p o l o g o
antártico	a n t a r t i k o
antítesis	a n t i t e s i s
anzuelo	a n T w e l o
análogo	a n a l o g o
anécdota	a n e g d o t a
anís	a n i s
anónimo	a n o n i m o
apagar	a p a g a 4
apagón	a p a g o n
aparte	a p a r t e
apatía	a p a t i a
apañar	a p a J a 4
apelativo	a p e l a t i b o
apersonarse	a p e r s o n a r s e
apertura	a p e r t u 4 a
aperturar	a p e r t u 4 a 4
apetecer	a p e t e T e 4
apio	a p j o
aplauso	a p l a u s o
apocalipsis	a p o k a l i p s i s
apocalíptico	a p o k a l i p t i k o
apogeo	a p o x e o
apología	a p o l o x i a
aportar	a p o 4 t a 4
apoyo	a p o J\j\ o
app	a p
apreciar	a p 4 e T j a 4
apretado	a p 4 e t a D o
apretar	a p 4 e t a 4
aprovecharse	a p 4 o b e tS a r s e
aproximar	a p 4 o g s i m a 4
aptitud	a p t i t u d
apuntar	a p u n t a 4
apéndice	a p e n D i T e
apóstol	a p o s t o l
aquí	a k i
ara	a 4 a
araña	a 4 a J a
arce	a 4 T e
archipiélago	a r tS i p j e l a g o
archivo	a r tS i b o
arcángel	a r k a n x e l
arder	a 4 d e 4
ardid	a 4 D i D
ardilla	a r d i L a
aremos	a 4 e m o s
arena	a 4 e n a
arepa	a 4 e p a
argentino	a r x e n t i n o
armada	a r m a d a
armadillo	a r m a d i L o
armar	a r m a 4
armario	a r m a 4 j o
armenio	a r m e n j o
aro	a 4 o
aroma	a 4 o m a
aromatizar	a 4 o m a t i T a 4
arpa	a r p a
arquetipo	a r k e t i p o
arqueólogo	a r k e o l o g o
arquitecto	a r k i t e g t o
arquitectónico	a r k i t e g t o n i k o
arrancar	a r a n k a 4
arrastra	a r a s t 4 a
arriba	a r i b a
arritmia	a r i t m j a
arroyo	a r o J\j\ o
arroz	a r o T
arsenal	a r s e n a l
arsénico	a r s e n i k o
arte	a 4 t e
artimaña	a r t i m a J a
arzobispo	a 4 T o B i s p o
as	a s
asa	a s a
asada	a s a d a
asado	a s a d o
asar	a s a 4
ascetismo	a s T e t i s m o
asco	a s k o
ase	a s e
ases	a s e s
asesinato	a s e s i n a t o
asfixia	a s f i g s j a
asiduo	a s i d w o
asistencia	a s i s t e n T j a
asiático	a s j a t i k o
asma	a s m a
asmático	a s m a t i k o
asno	a s n o
aspa	a s p a
asta	a s t a
asterisco	a s t e 4 i s k o
asteroide	a s t e 4 o i d e
astral	a s t 4 a l
astro	a s t 4 o
astronauta	a s t 4 o n a u t a
astronomía	a s t 4 o n o m i a
astrónomo	a s t 4 o n o m o
astur	a s t u 4
asturiano	a s t u 4 j a n o
asustar	a s u s t a 4
asá	a s a
así	a s i
ata	a t a
ataúd	a t a u d
ate	a t e
atemorizar	a t e_~ m o 4 i T a 4
ateo	a t e o
aterciopelado	a t e 4 T j o p e l a D o
aterrizaje	a t e r i s a x e
atlante	a t l a n t e
atlas	a t l a s
atleta	a t l e t a
atlético	a t l e t i k o
atmósfera	a t m o s f e 4 a
atocha	a t o tS a
atractivo	a t 4 a k t i B o
atrapado	a t 4 a p a d o
atrapar	a t 4 a p a 4
atravesar	a t 4 a b e s a 4
atropellar	a t 4 o p e L a 4
atropello	a t 4 o p e L o
atuendo	a t w e n d o
atómico	a t o m i k o
atún	a t u n
audiencia	a w d j e n T j a
auditor	a u d i t o 4
auge	a u x e
aun	a u n
aunque	a u n k e
auricular	a u 4 i k u l a 4
ausencia	a u s e n T j a
autenticidad	a u t e n t i T i D a D
autismo	a u t i s m o
automóvil	a u t o m o b i l
autonomía	a u t o n o m i a
autoridad	a u t o 4 i d a d
autorretrato	a u t o r\ e t 4 a t o
auténtico	a u t e n t i k o
autónomo	a u t o n o m o
aval	a b a l
avaluar	a b a l w a 4
avaricia	a B a 4 i T j a
ave	a b e
avena	a b e n a
aventar	a b e n t a 4
aventura	a b e n t u 4 a
avergonzar	a b e r g o n T a 4
averiguar	a B e 4 i G w a 4
avispa	a b i s p a
avión	a b j o n
axila	a g s i l a
axilas	a g s i l a s
axioma	a g s j o m a
ay	a i
ayote	a j\ o t e
ayuda	a J\j\ u d a
ayudar	a J\j\ u d a 4
ayudarla	a j\ u D a 4 l a
ayudarle	a j\ u D a 4 l e
ayudarles	a j\ u D a 4 l e s
ayudarlo	a j\ u D a 4 l o
ayudarlos	a j\ u D a 4 l o s
ayudarme	a j\ u D a 4 m e
ayudarnos	a j\ u D a 4 n o s
ayudarte	a j\ u D a 4 t e
ayuntamiento	a J\j\ u n t a m j e n t o
ayúdame	a J\j\ u d a m e
azada	a T a d a
azafata	a T a f a t a
azafrán	a T a f 4 a n
azahar	a T a a 4
azalea	a T a l e a
azar	a T a 4
azorado	a T o 4 a d o
azotar	a T o t a 4
azote	a T o t e
azotea	a T o t e a
azteca	a T t e k a
azufre	a T u f 4 e
azul	a T u l
azúcar	a T u k a 4
aéreo	a e 4 e o
añadir	a J a d i 4
añicos	a J i k o s
año	a J o
años	a J o s
aún	a u n
b	b
baba	b a b a
baboso	b a b o s o
bache	b a tS e
bagre	b a G 4 e
bagual	b a g w a l
bahía	b a i a
bailar	b a i l a r
baja	b a x a
bajito	b a x i t o
bajo	b a x o
bajón	b a x o n
balacera	b a l a T e 4 a
balcón	b a l k o n
balda	b a l d a
ballena	b a L e n a
ballet	b a l e
baloncesto	b a l o n T e s t o
balsero	b a l s e 4 o
balón	b a l o n
banal	b a n a l
banano	b a n a n o
banca	b a n k a
banda	b a n d a
bandera	b a n d e 4 a
banqueta	b a n k e t a
bao	b a o
baptista	b a b t i s t a
barato	b a 4 a t o
barba	b a r b a
barbecho	b a 4 B e t S o
barbería	b a r b e 4 i a
barbilla	b a r b i L a
barbudo	b a r b u d o
barca	b a 4 k a
barcaza	b a 4 k a T a
bardo	b a r d o
bario	b a 4 j o
barman	b a r m a n
barnizar	b a r n i T a 4
barra	b a r a
barracuda	b a r a k u d a
barrena	b a r e n a
barriga	b a r i G a
barril	b a r i l
barrio	B a r j o
barón	b a 4 o n
basamento	b a s a m e n t o
bastión	b a s t j o n
basto	b a s t o
bastó	b a s t o
bastón	b a s t o n
basílica	b a s i l i k a
batalla	b a t a L a
batata	b a t a t a
bato	b a t o
bautismo	b a u t i s m o
bautista	b a u t i s t a
bautizar	b a u t i T a 4
baya	b a j a
bayoneta	b a J\j\ o n e t a
bañar	b a J a 4
baño	b a J o
be	b e
beber	b e B e 4
bebida	b e b i d a
bebido	b e b i d o
becerro	b e T e r o
beige	b e i s
belicoso	b e l i k o s o
bella	b e L a
belleza	b e L e T a
bello	b e L o
benevolencia	b e n e b o l e n T j a
benévolo	b e n e b o l o
berilio	b e 4 i l j o
bes	b e s
beta	b e t a
betún	b e t u n
bezoar	b e T o a 4
biblia	b i b l j a
bibliografía	b i b l j o g 4 a f i a
biblioteca	b i b l j o t e k a
bicameral	b i k a m e 4 a l
bici	b i T i
bicicleta	b i T i k l e t a
bielorruso	b j e l o r u s o
bien	b j e n
bienvenida	b j e m b e n i d a
bienvenido	b j e m b e n i d o
bigote	b i g o t e
bilateral	b i l a t e 4 a l
bilingüismo	b i l i N g w i z m o
billar	b i L a 4
billón	b i L o n
biodegradable	b i o d e g 4 a d a b l e
biografía	b j o g 4 a f i a
biología	b j o l o x i a
birmana	b i r m a n a
birra	b i r a
bisagra	b i s a g 4 a
bisexualidad	b i s e g s w a l i d a d
bisonte	b i s o n t e
bistec	b i s t e k
bitácora	b i t a k o 4 a
bizarro	b i s a r o
bizcocho	b i T k o tS o
blanca	b l a n k a
blancas	b l a n k a s
blanco	b l a N k o
blancos	b l a n k o s
blanquear	b l a n k e a 4
blanquecino	b l a n k e T i n o
blanquito	b l a n k i t o
blasfemar	b l a s f e m a 4
blasfemia	b l a s f e m j a
block	b l o k
bloquera	b l o k e 4 a
boa	b o a
bobina	B o B i n a
bobo	b o b o
boca	b o k a
bocadillo	b o k a d i L o
bocata	b o k a t a
boceto	b o T e t o
bochorno	b o tS o r n o
boda	b o d a
bodega	b o d e g a
bodorrio	b o d o r j o
boga	b o g a
boicot	b o j k o t
bola	b o l a
boletos	b o l e t o s
boletín	b o l e t i n
bolsa	B o l s a
boludo	b o l u d o
bomba	b o m b a
boniato	b o n j a t o
bonito	B o n i t o
bono	b o n o
boquiabierto	b o k i a B i e 4 t o
borda	b o 4 D a
bordado	b o r d a d o
boro	b o 4 o
borra	b o r a
borrachera	b o r a tS e 4 a
borracho	b o r a tS o
borrar	b o r a 4
borrego	b o r e g o
borró	b o r o
bosnio	b o s n i o
bosque	b o s k e
bostezar	b o s t e T a 4
bostezo	b o s t e T o
botar	b o t a 4
botella	b o t e L a
boto	b o t o
botánico	b o t a n i k o
botón	b o t o n
bovino	b o B i n o
boya	b o J\j\ a
boîte	b w a t
bragas	b 4 a g a s
braguitas	b 4 a g i t a s
brainstorming	b 4 e i n s t o r m i n
brasa	b 4 a s a
brasileño	b 4 a s i l e J o
bravo	b 4 a b o
brazo	b 4 a T o
bretón	b 4 e t o N
breve	b 4 e b e
brevedad	b 4 e B e D a D
breña	b 4 e J a
brillante	b 4 i L a n t e
brillar	b 4 i L a 4
brindis	b 4 i n d i s
brisa	b 4 i s a
brisas	b 4 i s a s
broche	b 4 o tS e
broma	b 4 o m a
bronca	b 4 o n k a
bruja	b 4 u x a
bruma	b 4 u m a
brusca	b 4 u s k a
bruschetta	b 4 u s k e t a
bruscos	b 4 u s k o s
brutal	b 4 u t a l
brócoli	b 4 o k o l i
brújula	b 4 u x u l a
budismo	b u D i s m o
buen	b w e n
bueno	b w e n o
buey	b w e i
bueyes	b w e J\j\ e s
bujía	b u x i a
bula	b u l a
bulbo	b u l b o
bulevar	b u l e B a 4
bullying	b u l i i n
bulto	b u l t o
burbuja	b u 4 b u x a
burdel	b u 4 D e l
burguer	b u r g e 4
burgués	b u r g e s
burrito	b u r i t o
burro	b u r o
busca	b u s k a
buscar	b u s k a 4
buscas	b u s k a s
busqué	b u s k e
butaca	b u t a k a
buzón	b u T o n
buñuelo	b u J w e l o
bádminton	b a d m i n t o n
bálsamo	b a l s a m o
bárbaro	b a r b a 4 o
básquetbol	b a s k e t B o l
bíceps	b i T e p s
bóveda	b o b e d a
bóxer	b o g s e 4
búlgara	b u l g a 4 a
búnker	b u n k e r
búsqueda	b u s k e d a
ca	k a
caballas	k a B a L a s
caballero	k a B a L e 4 o
caballo	k a b a L o
caballos	k a B a L o s
cabecilla	k a b e T i L a
cabello	k a b e L o
caber	k a b e 4
cabeza	k a b e T a
cabildo	k a b i l d o
cabo	k a b o
cabrear	k a b 4 e a 4
cabrito	k a B 4 i t o
cabro	k a b 4 o
cabrón	k a b 4 o n
cacahuete	k a k a w e t e
cacao	k a k a o
cacerola	k a T e 4 o l a
cacerolada	k a T e 4 o l a d a
cacha	k a tS a
cachete	k a tS e t e
cachirulo	k a tS i 4 u l o
cachondo	k a tS o n d o
cada	k a d a
cadáver	k a D a B e 4
cae	k a e
caer	k a e 4
caerse	k a e r s e
cafetín	k a f e t i n
cagar	k a g a 4
cagarse	k a g a r s e
caiga	k a i g a
caimán	k a i m a n
caja	k a x a
cajón	k a x o n
cake	k e i g
cala	k a l a
calabaza	k a l a b a T a
calabozo	k a l a B o T o
calamar	k a l a m a 4
calambre	k a l a m b 4 e
calcetín	k a l T e t i n
calcio	k a l T j o
calco	k a l k o
caldo	k a l d o
caleidoscópico	k a l e i d o s k o p i k o
calendario	k a l e n d a 4 j o
calentar	k a l e n t a 4
calibre	k a l i b 4 e
calidad	k a l i d a d
caliente	k a l j e n t e
califa	k a l i f a
caligrafía	k a l i g 4 a f i a
calistenia	k a l i s t e n j a
callado	k a L a d o
callar	k a L a 4
calle	k a L e
callejón	k a L e x o n
callo	k a L o
calló	k a L o
calma	k a l m a
calmante	k a l m a n t e
calmar	k a l m a 4
calor	k a l o 4
calvo	k a l b o
caléndula	k a l e n d u l a
caló	k a l o
camaleón	k a m a l e o n
camarada	k a m a 4 a d a
camarón	k a m a 4 o n
camboyano	k a m b o j\ a n o
camello	k a m e L o
caminar	k a m i n a 4
camino	k a m i n o
camionero	k a m j o n e 4 o
camisa	k a m i s a
camorra	k a m o r a
campana	k a m p a n a
campanario	k a m p a n a 4 j o
campaña	k a m p a J a
campeonato	k a m p e o n a t o
campeón	k a m p e o n
camping	k a m p i n g
campiña	k a m p i J a
campo	k a m p o
camposanto	k a m p o s a n t o
can	k a n
cana	k a n a
canal	k a n a l
canalla	k a n a L a
canas	k a n a s
canciones	k a n T i o n e s
canción	k a n T j o n
candado	k a n d a d o
canelón	k a n e l o n
cangrejo	k a N g 4 e x o
cani	k a n i
canica	k a n i k a
canijo	k a n i x o
canilla	k a n i L a
canina	k a n i n a
cano	k a n o
canon	k a n o n
cantante	k a n t a n t e
cantar	k a n t a 4
cantidad	k a n t i d a d
canto	k a n t o
cantó	k a n t o
cantón	k a n t o n
canónico	k a n o n i k o
caolín	k a o l i n
caos	k a o s
capa	k a p a
capacidad	k a p a T i d a d
capar	k a p a 4
capaz	k a p a T
capilar	k a p i l a 4
capital	k a p i t a l
capitalismo	k a p i t a l i z m o
capitolio	k a p i t o l j o
capitán	k a p i t a n
captar	k a b t a 4
capturar	k a p t u 4 a 4
capture	k a p t u 4 e
carabina	k a 4 a b i n a
caracola	k a 4 a k o l a
caracteres	k a 4 a g t e 4 e s
carajo	k a 4 a x o
caramba	k a 4 a m b a
carambola	k a 4 a m b o l a
caraota	k a 4 a o t a
caras	k a 4 a s
carbono	k a r b o n o
carbón	k a 4 B o n
cardenal	k a r d e n a l
cardiaco	k a r d j a k o
cardinal	k a r d i n a l
cardíaco	k a r d i a k o
carecer	k a 4 e s e 4
caribú	k a 4 i B u
caricatura	k a 4 i k a t u 4 a
caricaturizar	k a 4 i k a t u 4 i T a 4
caries	k a 4 j e s
carisma	k a 4 i s m a
carnal	k a 4 n a l
carnaval	k a r n a b a l
carne	k a r n e
caro	k a 4 o
caros	k a 4 o s
carpeta	k a r p e t a
carreta	k a r e t a
carretera	k a r e t e 4 a
carro	k a r o
carta	k a r t a
cartel	k a r t e l
cartografiar	k a r t o g 4 a f j a 4
cartografía	k a r t o g 4 a f i a
cartucho	k a r t u tS o
cartón	k a r t o n
carácter	k a 4 a g t e 4
carísimo	k a 4 i s i m o
casa	k a s a
casado	k a s a d o
casan	k a s a n
casar	k a s a 4
cascada	k a s k a d a
cascarla	k a s k a r l a
casero	k a s e 4 o
caserío	k a s e 4 i o
casi	k a s i
caspa	k a s p a
cassata	k a s a t a
casta	k a s t a
castaña	k a s t a J a
castañas	k a s t a J a s
castellano	k a s t e L a n o
casucha	k a s u tS a
cataclismo	k a t a k l i s m o
catalanes	k a t a l a n e s
catapulta	k a t a p u l t a
catar	k a t a 4
catarro	k a t a r o
catarsis	k a t a 4 s i s
catedrático	k a t e d 4 a t i k o
catequesis	k a t e k e s i s
catorce	k a t o 4 T e
catálisis	k a t a l i s i s
católico	k a t o l i k o
caudal	k a u D a l
caudillo	k a u d i L o
causa	k a u s a
caverna	k a b e r n a
caviar	k a b j a 4
cavo	k a B o
cayado	k a J\j\ a d o
cayo	k a j\ o
cayó	k a L o
caza	k a T a
cazador	k a T a D o 4
cazamariposas	k a T a m a 4 i p o s a s
cazar	k a T a 4
cazón	k a T o n
caí	k a i
caña	k a J a
caño	k a J o
cañón	k a J o n
ce	T e
cebada	T e b a d a
cebo	T e B o
cebra	T e B 4 a
cebú	T e B u
ceda	T e d a
cede	T e d e
ceder	T e D e 4
cedo	T e d o
cefalea	T e f a l e a
cegar	T e g a 4
ceja	T e x a
celebre	T e l e B 4 e
celestial	T e l e s t j a l
celo	T e l o
celos	T e l o s
cementerio	T e m e n t e 4 j o
cena	T e n a
cenar	T e n a r
cenote	T e n o t e
centella	T e n t e L a
centena	T e n t e n a
centenar	T e n t e n a 4
centro	T e n t 4 o
centrífugo	T e n t 4 i f u g o
cepillar	T e p i L a 4
cera	T e 4 a
cercano	T e r k a n o
cerdo	T e r d o
cerebro	T e 4 e B 4 o
cereza	T e 4 e T a
cero	z e 4 o
cerquita	T e r k i t a
cerrado	T e r a d o
cerrar	T e r a 4
cerrojo	T e r o x o
certamen	T e 4 t a m e n
certeza	T e r t e T a
certidumbre	T e r t i d u m b 4 e
cerveza	T e 4 B e T a
cerámica	T e 4 a m i k a
cerámico	T e 4 a m i k o
ces	T e s
cese	T e s e
cesio	T e s j o
cetro	T e t 4 o
chacal	tS a k a l
chacota	tS a k o t a
chalupa	tS a l u p a
champaña	tS a m p a J a
champán	tS a m p a n
champú	tS a m p u
chamán	tS a m a n
chan	tS a n
chance	tS a n T e
chanchullo	tS a n tS u L o
chancla	tS a n k l a
chapeau	t S a p o
chapo	tS a p o
chapucear	tS a p u T e a 4
chapulín	tS a p u l i n
chapuza	tS a p u T a
chatarra	tS a t a r a
chatear	tS a t e a 4
chateo	tS a t e o
chato	tS a t o
checar	tS e k a 4
checheno	tS e tS e n o
chequear	tS e k e a 4
cheve	t S e b e
chica	tS i k a
chicana	tS i k a n a
chicano	t S i k a n o
chicha	tS i tS a
chichi	tS i tS i
chicle	tS i k l e
chico	tS i k o
chicote	tS i k o t e
chido	tS i d o
chikunguña	tS i k u n g u J a
chile	t S i l e
chileno	tS i l e n o
chili	tS i l i
chillar	tS i L a 4
chimpancé	t S i m p a n T e
chin	tS i n
chingado	tS i n g a d o
chino	tS i n o
chipotle	t S i p o t K e
chiquita	tS i k i t a
chiquito	tS i k i t o
chiquitín	tS i k i t i n
chispa	tS i s p a
chispear	tS i s p e a 4
chiste	tS i s t e
chistorra	tS i s t o r a
chita	tS i t a
chivato	tS i b a t o
chocar	t S o k a 4
chocho	t S o t S o
chocolate	tS o k o l a t e
chofer	tS o f e 4
cholo	tS o l o
choque	tS o k e
choques	tS o k e s
chorear	tS o 4 e a 4
chorizo	tS o 4 i T o
chota	tS o t a
chueco	tS w e k o
chulear	tS u l e a 4
chulo	tS u l o
chupa	tS u p a
chupacabras	tS u p a k a b 4 a s
chupar	tS u p a 4
chupete	tS u p e t e
chupito	tS u p i t o
churri	tS u r i
churro	tS u r o
cian	T j a n
cianuro	T j a n u 4 o
cicatriz	T i k a t 4 i T
cicatrizar	T i k a t 4 i T a 4
ciclo	T i k l o
ciclón	T i k l o n
ciego	T j e G o
cielo	T j e l o
cien	T j e n
ciencia	T j e n T j a
cienmil	T j e m m i l
ciento	T j e n t o
científica	T j e n t i f i k a
científico	T j e n t i f i k o
cierra	T j e r a
cierran	T j e r a n
cierre	T j e r e
cierres	T j e r e s
ciertamente	T j e r t a m e n t e
cierto	T j e r t o
ciervo	T j e r b o
cigarrillo	T i g a r i L o
cigarro	T i g a r o
cilantro	T i l a n t 4 o
cilicio	d s i l i d s j o
cima	T i m a
cimarrón	T i m a r o n
cinco	T i n k o
cincuenta	T i n k w e n t a
cineasta	T i n e a s t a
cinismo	T i n i s m o
ciprés	T i p r e s
circunferencia	T i r k u n f e 4 e n T j a
circunvalar	T i r k u m b a l a 4
cirrosis	T i r o s i s
cirugía	T i 4 u x i a
cisco	T i s k o
cisne	T i s n e
cita	T i t a
ciudad	T j u d a d
ciudades	T j u D a D e s
civil	T i B i l
cizalla	T i T a L a
clarinete	k l a 4 i n e t e
clases	k l a s e s
clausura	k l a u s u 4 a
clavel	k l a b e l
clavija	k l a b i x a
clavo	k l a b o
claxon	k l a g s o n
cliché	k l i tS e
cliente	k l j e n t e
clientela	k l j e n t e l a
clima	k l i m a
cloro	k l o 4 o
cloruro	k l o 4 u 4 o
club	k l u B
clérigo	k l e 4 i g o
coartar	k o a r t a 4
cobalto	k o b a l t o
cobarde	k o b a r d e
cobertizo	k o B e 4 t i T o
cobra	k o b 4 a
cobre	k o B 4 e
coca	k o k a
cocainómano	k o k a i n o m a n o
cocer	k o T e r
cochino	k o tS i n o
cocido	k o T i d o
cocina	k o T i n a
coco	k o k o
codo	k o d o
codorniz	k o D o 4 n i T
coger	k o x e 4
cognitiva	k o g n i t i b a
cogote	k o g o t e
coito	k o i t o
cojear	k o x e a 4
cojo	k o x o
cojones	k o x o_~ n e s
cojín	k o x i n
cojón	k o x o n
col	k o l
cola	k o l a
colcha	k o l tS a
colchón	k o l tS o n
colega	k o l e g a
colina	k o l i n a
colirio	k o l i 4 j o
colocado	k o l o k a D o
colocar	k o l o k a 4
coloquial	k o l o k j a l
coloquio	k o l o k j o
color	k o l o 4
coloso	k o l o s o
columna	k o l u m n a
colón	k o l o n
coma	k o m a
comadreja	k o m a d 4 e x a
comarca	k o m a r k a
come	k o m e
comedia	k o m e d j a
comemierda	k o m e m j e r d a
comensal	k o m e n s a l
comenzar	k o m e n T a 4
comer	k o m e 4
comercial	k o m e 4 T j a l
comes	k o m e s
cometa	k o m e t a
comida	k o m i d a
comillas	k o m i L a s
comisario	k o m i s a 4 j o
comió	k o m j o
como	k o m o
compacta	k o m p a g t a
compadre	k o m p a D 4 e
comparar	k o m p a 4 a 4
comparare	k o m p a 4 a 4 e
compartimento	k o m p a r t i m e n t o
compaña	k o m p a J a
compañía	k o m p a J i a
complejo	k o m p l e x o
completo	k o_~ m p l e t o
complicación	k o_~ m p l i k a T j o_~ n
complicado	k o_~ m p l i k a D o
complicar	k o m p l i k a 4
complot	k o m p l o t
comprar	k o m p 4 a 4
comprender	k o m p 4 e n d e 4
comprensión	k o m p 4 e n s j o n
comprometer	k o m p 4 o m e t e 4
compromiso	k o m p 4 o m i s o
compuesto	k o m p w e s t o
compulsar	k o m p u l s a 4
compás	k o m p a s
comunidad	k o m u n i D a D
comunidades	k o m u n i D a D e s
comí	k o m i
con	k o n
concebir	k o n T e b i 4
concejo	k o_~ n T e x o
conceptual	k o n T e b t w a l
concha	k o n tS a
conde	k o n d e
conducción	k o n d u k T j o n
conejo	k o n e x o
confidencial	k o n f i d e n T j a l
configurable	k o n f i g u 4 a b l e
confirmar	k o n f i 4 m a 4
confirmo	k o n f i 4 m o
confortable	k o_~ F f o 4 t a B l e
congreso	k o N g 4 e s o
conjuntar	k o n x u n t a 4
conjunto	k o n X u n t o
conmigo	k o m m i g o
cono	k o n o
conoce	k o n o T e
conocer	k o n o d s e 4
conocí	k o n o T i
conozco	k o n o T k o
conque	k o n k e
conquistador	k o n k i s t a d o 4
consanguinidad	k o n s a n g i n i d a d
conseguir	k o n s e g i 4
consejo	k o_~ n s e x o
consentir	k o n s e n t i 4
considerable	k o n s i d e 4 a b l e
consigo	k o n s i g o
consolador	k o n s o l a d o 4
constatar	k o n s t a t a 4
consuelo	k o n s w e l o
consular	k o n s u l a 4
consumista	k o n s u m i s t a
contaminación	k o n t a m i n a T j o n
contentarse	k o n t e n t a r s e
contigo	k o n t i g o
continuar	k o n t i n w a 4
continuo	k o n t i n w o
continúo	k o n t i n u o
contornear	k o n t o r n e a 4
contra	k o n t 4 a
contractual	k o n t 4 a g t w a l
contraseña	k o n t 4 a s e J a
control	k o n t 4 o l
contubernio	k o n t u b e r n j o
convenir	k o m b e n i 4
conversación	k o_~ n b e 4 s a s j o_~ n
convexo	k o m b e g s o
convoy	k o m b o i
copa	k o p a
copla	k o p l a
coraje	k o 4 a x e
coral	k o 4 a l
corazón	k o 4 a T o n
corbata	k o r b a t a
cordero	k o r d e 4 o
cordón	k o r d o n
coreana	k o 4 e a n a
coreano	k o 4 e a n o
corpus	k o r p u s
corral	k o r a l
correcto	k o r e g t o
corrida	k o r i d a
corriente	k o r j e n t e
corsé	k o 4 s e
cortado	k o r t a d o
corte	k o 4 t e
corto	k o r t o
coruñés	k o 4 u J e s
cosa	k o s a
cosecha	k o s e t S a
coser	k o s e r
cosmos	k o s m o s
costal	k o s t a l
coste	k o s t e
costoso	k o s t o s o
costumbre	k o s t u m b 4 e
coto	k o t o
covacha	k o b a tS a
coyote	k o j\ o t e
coágulo	k o a M\ u l o
coñazo	k o J a T o
coño	k o J o
crear	k 4 e a 4
crecer	k 4 e T e 4
creer	k 4 e e 4
crema	k 4 e m a
creo	k 4 e o
cretinez	k 4 e t i n e T
crianza	k 4 j a n T a
criatura	k 4 j a t u 4 a
crisis	k 4 i s i s
crisol	k 4 i s o l
cristal	k 4 i s t a l
cristiandad	k 4 i s t j a n d a d
cromado	k 4 o m a D o
cronología	k 4 o n o l o x i a
cruce	k 4 u T e
cruces	k 4 u T e s
crucifijo	k 4 u T i f i x o
crucigrama	k 4 u T i g 4 a m a
crudo	k 4 u D o
crueldad	k 4 u e l d a D
cruento	k 4 w e n t o
cruz	k 4 u d s
cráneo	k 4 a n e o
crédito	k 4 e d i t o
crítico	k 4 i t i k o
cu	k u
cuadrado	k w a D 4 a D o
cuadrar	k w a D 4 a 4
cuajada	k w a x a d a
cuajo	k w a x o
cualidad	k w a l i d a d
cuando	k w a n d o
cuanta	k w a n t a
cuanto	k w a n t o
cuantía	k w a n t i a
cuarenta	k w a 4 e n t a
cuartel	k w a r t e l
cuarto	k w a 4 t o
cuarzo	k w a 4 T o
cuatro	k w a t 4 o
cuatrocientos	k w a t 4 o T j e n t o s
cubano	k u b a n o
cubismo	k u B i z m o
cubo	k u b o
cuchilla	k u t S i L a
cuchillo	k u t S i L o
cucurucho	k u k u 4 u tS o
cuello	k w e L o
cuenco	k w e n k o
cuero	k w e 4 o
cuerpo	k w e r p o
cuervo	k w e 4 B o
cuesta	k w e s t a
cuestionario	k w e s t j o n a 4 j o
cueva	k w e B a
cuidado	k w i d a d o
cuidador	k w i d a d o 4
culantro	k u l a n t 4 o
culebra	k u l e b 4 a
culito	k u l i t o
culo	k u l o
cultura	k u l t u 4 a
cultural	k u l t u 4 a l
cumbia	k u m b j a
cumbre	k u m b 4 e
cumpleaños	k u m p l e a J o s
cumplirse	k u m p l i r s e
cuna	k u n a
cupero	k u p e 4 o
curable	k u 4 a b l e
currelar	k u r e l a 4
curro	k u r o
curruca	k u r u k a
cus	k u s
cutis	k u t i s
cutre	k u t 4 e
cuya	k u j a
cuyo	k u j o
cuál	k w a l
cuándo	k w a n d o
cuánto	k w a n t o
cuña	k u J a
cuño	k u J o
cálculo	k a l k u l o
cáliz	k a l i T
cámara	k a m a 4 a
cámaro	k a m a 4 o
cántico	k a n t i k o
cárcel	k a 4 T e l
cártel	k a r t e l
cáscara	k a s k a 4 a
cáñamo	k a J a m o
célula	T e l u l a
césped	T e s p e d
cíclico	T i k l i k o
cínico	T i n i k o
cívico	T i B i k o
cólera	k o l e 4 a
cómico	k o m i k o
cómo	k o m o
cóndor	k o n d o 4
cónyuge	k o n j\ u x e
cósmico	k o s m i k o
cúpula	k u p u l a
cúrcuma	k u r k u m a
cúspide	k u s p i d e
d	d
daba	d a B a
dado	d a d o
dales	d a l e s
dalia	d a l j a
dance	d a n T e
dantesco	d a n t e s k o
dar	d a 4
daño	d a J o
de	d e
debajo	d e b a x o
debe	d e B e
deber	d e b e 4
decente	d e T e n t e
decidido	d e T i D i D o
decir	d e T i 4
declinación	D e k l i n a T j o n
decolorar	d e k o l o 4 a 4
decorativa	d e k o 4 a t i b a
decrecimiento	d e k 4 e T i m j e n t o
dedal	d e D a l
dedo	d e d o
deducir	d e D u T i 4
definir	d e f i n i 4
degollar	d e g o L a 4
degüello	d e g w e L o
dejar	d e x a 4
del	d e l
delantal	d e l a n t a l
delfín	d e l f i n
delincuencia	D e l i N k w e n T j a
delirio	d e l i 4 j o
delito	d e l i t o
demasía	d e m a s i a
deme	d e m e
democracia	d e m o k 4 a T j a
democratizar	d e m o k r a t i T a 4
democrático	d e m o k 4 a t i k o
demonio	d e m o n j o
demoníaco	d e m o n i a k o
demás	d e m a s
den	d e n
denigrar	d e n i g 4 a 4
dentadura	d e_~ n t a D u 4 a
deportar	d e p o r t a 4
derecha	d e 4 e tS a
derecho	d e 4 e tS o
derrotista	d e r o t i s t a
des	d e s
desagradable	d e s a g 4 a d a b l e
desagüe	d e s a g w e
desalojo	d e s a l o x o
desaparecer	d e s a p a 4 e T e 4
desatornillar	d e s a t o r n i L a 4
desbancar	d e s b a n k a 4
descartar	d e s k a r t a 4
descender	d e s T e n d e 4
descendiente	d e s T e n d j e n t e
desclasificar	d e h k l a s i f i k a 4
descomprimir	d e s k o m p 4 i m i 4
descontinuar	d e s k o n t i n w a 4
descontrol	d e s k o n t 4 o l
descoser	d e s k o s e 4
descubrimiento	d e s k u b 4 i m j e n t o
desde	d e s d e
desdeñar	d e s d e J a 4
desdén	d e s d e n
desear	d e s e a 4
desecho	d e s e tS o
desechó	d e s e tS o
desembragar	d e s e m b 4 a g a 4
desenfocar	d e s e n f o k a 4
desesperar	d e s e s p e 4 a 4
desestimular	d e s e s t i m u l a 4
desfalco	d e s f a l k o
desfinanciar	d e s f i n a n T j a 4
desganado	d e s g a n a d o
desguace	d e s g w a T e
deshacer	d e s a T e 4
deshecho	d e s e tS o
deshidratación	d e s i D 4 a t a T j o n
desnuda	d e s n u d a
desnudas	d e s n u d a s
desnudo	d e s n u D o
despacio	d e s p a T j o
despacito	d e s p a T i t o
despiadado	d e s p j a d a d o
desplegar	d e s p l e g a 4
desplomarse	d e s p l o m a r s e
despreocuparse	d e s p 4 e o k u p a r s e
después	d e s p w e s
destensar	d e s t e n s a 4
destino	D e s t i n o
desvirgar	d e s b i r g a 4
detente	d e t e n t e
detergente	d e t e r x e n t e
determinar	d e t e r m i n a 4
deuda	d e u d a
devoto	d e b o t o
di	d i
diablo	d j a b l o
diacrítico	d j a k 4 i t i k o
diadema	d j a d e m a
diafragma	d j a f 4 a g m a
diagrama	d j a g 4 a m a
diamante	d j a m a n t e
diario	d j a 4 j o
diarrea	d j a r e a
dibujar	d i b u x a 4
diccionario	d i k T j o n a 4 j o
dicción	d i k T j o n
dices	d i T e s
dichoso	d i tS o s o
diciembre	d i T j e m b 4 e
dicotomía	d i k o t o m i a
dictar	d i g t a 4
didáctico	d i d a g t i k o
diecinueve	d j e T i n w e b e
dieciocho	d j e T j o tS o
diecisiete	d j e T i s j e t e
dieciséis	d j e T i s e i s
diente	d j e_~ n t e
diera	d j e 4 a
dieta	d j e t a
dietético	d j e t e t i k o
diez	d j e T
diezmar	d j e T m a 4
diezmo	d j e T m o
diferenciación	d i f e 4 e n T j a T j o n
diferenciar	d i f e 4 e n T j a 4
difícil	d i f i T i l
digno	d i g n o
dije	d i x e
dijimos	d i x i m o s
dijo	d i x o
dilema	d i l e m a
diletante	d i l e t a n t e
diluir	d i l w i 4
dinero	d i n e 4 o
dinosaurio	d i n o s a u 4 j o
dio	d j o
diodo	D j o D o
dios	d j o s
diosa	d j o s a
direccionar	d i 4 e g T j o n a 4
dirección	d i 4 e k T j o n
directo	d i 4 e g t o
diré	d i 4 e
discernir	D i s T e 4 n i 4
disco	d i s k o
disfrutar	d i s f 4 u t a 4
disparate	d i s p a 4 a t e
disponerse	d i s p o n e r s e
distinguir	D i s t i N G i 4
diurno	d j u 4 n o
diurético	d j u 4 e t i k o
divertimento	d i b e r t i m e n t o
divertimiento	d i b e r t i m j e n t o
divinidad	d i B i n i D a D
divino	d i b i n o
divisa	d i b i s a
diámetro	d j a m e t 4 o
diócesis	d j o T e s i s
doble	d o b l e
doblegar	d o b l e g a 4
doblegarse	d o b l e g a r s e
doce	d o T e
docena	d o T e n a
doctor	d o g t o 4
dogma	d o g m a
dogmático	d o g m a t i k o
doler	d o l e 4
domingo	d o m i n g o
dominicana	d o m i n i k a n a
dominio	d o m i n j o
domo	d o m o
doncella	d o n T e L a
donde	d o n d e
dope	d o p e
dormir	d o r m i 4
dos	d o s
doscientos	d o s T j e n t o s
dote	d o t e
doy	d o i
doña	d o J a
dragón	d 4 a g o n
dramaturga	d 4 a m a t u r g a
droga	d 4 o g a
dron	d 4 o n
druida	d 4 w i d a
duda	d u D a
dude	d u D e
duende	d w e n d e
duendecillo	d w e n d e T i L o
dueño	d w e J o
dulce	d u l T e
dulces	d u l T e s
duro	d u 4 o
dársena	d a 4 s e n a
dé	d e
débil	d e b i l
débito	D e B i t o
déspota	d e s p o t a
día	d i a
dólar	d o l a 4
dónde	d o n d e
e	e
ea	e a
ebullición	e b u L i T j o n
eccema	e k s e m a
echa	e tS a
echas	e tS a s
eche	e tS e
echo	e tS o
economía	e k o n o m i a
económica	e k o n o m i k a
económicas	e k o n o m i k a s
económico	e k o n o m i k o
económicos	e k o n o m i k o s
ecosistema	e k o s i s t e m a
ecuador	e k w a d o 4
ecuatoriano	e k w a t o 4 j a n o
ecuménico	e k u m e n i k o
edad	e D a D
edificio	e D i f i T j o
editar	e D i t a 4
editor	e d i t o 4
efe	e f e
efectivizar	e f e g t i b i T a 4
efímero	e f i m e 4 o
ego	e g o
eh	e
ejecución	e x e k u T j o n
ejecutar	e x e k u t a 4
ejemplo	e x e m p l o
ejercito	e x e 4 T i t o
ejido	e x i d o
ejército	e x e 4 T i t o
el	e l
ele	e l e
elección	e l e k s j o n
electricidad	e l e k t r i T i D a D
elefante	e l e f a n t e
elegía	e l e x i a
elemento	e l e m e n t o
eles	e l e s
elipse	e l i b s e
ella	e L a
ellas	e L a s
ello	e L o
ellos	e L o s
elocuencia	e l o k w e n T j a
elocuente	e l o k w e n t e
elusivo	e l u s i b o
eléctrico	e l e g t 4 i k o
embarcadero	e m b a r k a d e 4 o
emblema	e m b l e m a
embocar	e m b o k a 4
emborracharse	e_~ m b o r a t S a 4 s e
emboscar	e m b o s k a 4
embrague	e m b 4 a G e
embudo	e m b u D o
eme	e m e
emir	e m i 4
emirato	e m i 4 a t o
emoticono	e m o t i k o n o
emoticón	e m o t i k o n
empanada	e m p a n a d a
empañar	e m p a J a 4
empeine	e m p e j n e
empequeñecer	e m p e k e J e T e 4
emperador	e m p e 4 a d o 4
empezar	e m p e T a 4
empieza	e m p j e T a
empiezo	e m p j e T o
empoderamiento	e m p o d e 4 a m j e n t o
empoderar	e m p o d e 4 a 4
emprender	e m p 4 e n d e 4
emprendimiento	e m p 4 e n d i m j e n t o
emulsión	e m u l s j o n
en	e n
enamorada	e n a m o 4 a d a
enamorado	e n a m o 4 a d o
encantado	e n k a n t a d o
encanto	e N k a n t o
encargar	e n k a r g a 4
encerar	e n T e 4 a 4
enciclopedia	e n T i k l o p e D j a
enciendes	e n T j e n d e s
encierro	e n T j e r o
encima	e n T i m a
encontrarse	e n k o n t 4 a r s e
endeble	e n d e b l e
ene	e n e
enema	e n e m a
enemigo	e n e m i g o
energizar	e n e r x i T a 4
enero	e n e 4 o
enes	e n e s
enfermedad	e n f e r m e d a d
enfermero	e n f e r m e 4 o
enfermo	e n f e r m o
enfático	e n f a t i k o
enigma	e n i g m a
enigmático	e n i g m a t i k o
enjambre	e n x a m b r e
enjuto	e n x u t o
enlace	e n l a T e
ennegrecer	e n n e g 4 e T e 4
enorme	e n o 4 m e
enseñar	e n s e J a 4
enterrar	e n t e r a 4
entonces	e n t o n T e s
entrada	e_~ n t 4 a D a
entraña	e n t 4 a J a
entre	e n t 4 e
entrecot	e n t 4 e k o t
entregar	e n t 4 e g a 4
entropía	e n t 4 o p i a
entusiasmo	e n t u s j a s m o
entusiasta	e n t u s j a s t a
envase	e n b a s e
enviar	e_~ m b j a 4
envidia	e n b i d i a
epa	e p a
epidémico	e p i d e m i k o
epifanía	e p i f a n i a
epilepsia	e p i l e p s j a
episodio	e p i s o d j o
epitafio	e p i t a f j o
epígrafe	e p i g 4 a f e
epónimo	e p o n i m o
equidistante	e k i D i s t a n t e
equinoccio	e k i n o k T j o
equipar	e k i p a 4
equipo	e k i p o
equis	e k i s
ere	e 4 e
erección	e 4 e g T j o n
eres	e 4 e s
ergo	e r g o
erizo	e 4 i T o
ermita	e r m i t a
ermitaño	e 4 m i t a J o
eros	e 4 o s
erotismo	e 4 o t i s m o
errar	e r a 4
errata	e r a t a
erre	e r e
error	e r o 4
erráticamente	e r a t i k a m e n t e
eructar	e 4 u k t a 4
eróticas	e 4 o t i k a s
erótico	e 4 o t i k o
eróticos	e 4 o t i k o s
es	e s
esa	e s a
esas	e s a s
escama	e s k a m a
escandinavo	e s k a n d i n a b o
escarabajo	e s k a 4 a b a x o
escatimar	e s k a t i m a 4
escatología	e s k a t o l o x i a
escena	e s T e n a
escoba	e s k o b a
escobar	e s k o b a 4
escoger	e s k o x e 4
escombro	e s k o m b 4 o
escoria	e s k o 4 j a
escorial	e s k o 4 j a l
escorpión	e s k o 4 p j o n
escribir	e s k 4 i b i 4
escritor	e s k 4 i t o 4
escritura	e s k 4 i t u 4 a
escuadrón	e s k w a d 4 o n
escucha	e s k u tS a
escuchar	e s k u tS a 4
escudero	e s k u d e 4 o
escudo	e s k u d o
escudriñar	e s k u d 4 i J a 4
escuela	e s k w e l a
escupitajo	e s k u p i t a x o
escáner	e s k a n e 4
ese	e s e
eses	e s e s
esférico	e s f e 4 i k o
eslabón	e s l a b o n
esmeralda	e s m e 4 a l d a
esnifar	e s n i f a 4
esos	e s o s
esotérico	e s o t e 4 i k o
espacial	e s p a T j a l
espagueti	e s p a g e t i
espalda	e s p a l d a
espantoso	e s p a n t o s o
esparto	e s p a r t o
español	e s p a J o l
especia	e s p e T j a
especial	e s p e T j a l
especialmente	e s p e T j a l m e n t e
espectador	e s p e k t a D o 4
espectro	E s p e k t 4 o
espejo	e s p e x o
espejos	e s p e x o s
esperanzada	e s p e 4 a_~ n T a D a
esperanzado	e s p e 4 a_~ n T a D o
esperanzados	e s p e 4 a_~ n T a D o s
espiar	e s p j a 4
espina	e s p i n a
espinal	e s p i n a l
espionaje	e h p j o n a x e
esponja	e s p o N x a
esporádico	e s p o 4 a d i k o
esposa	e s p o s a
espuma	e s p u m a
espía	e s p i a
esqueleto	e s k e l e t o
esquema	e s k e m a
esquemático	e s k e m a t i k o
esquiar	e s k j a 4
esquizofrenia	e s k i T o f 4 e n j a
estaba	e s t a b a
estabais	e s t a b a i s
estaban	e s t a b a n
estabas	e s t a b a s
estaca	e s t a k a
estadio	e s t a d j o
estadounidense	e s t a D o u n i D e n s e
estancamiento	e s t a n k a m j e n t o
estancia	e s t a n T j a
estar	e s t a 4
estatus	e s t a t u s
este	e s t e
estertor	e s t e 4 t o 4
estetoscopio	e s t e t o s k o p j o
estigma	e s t i g m a
estigmatizar	e s t i G m a t i T a 4
estilo	e s t i l o
estival	e s t i b a l
estomacal	e s t o m a k a l
estonio	e s t o n j o
estos	e s t o s
estratagema	e s t 4 a t a x e m a
estratega	e s t 4 a t e g a
estrategia	e s t 4 a t e x j a
estrecho	e s t 4 e t S o
estrella	e s t 4 e L a
estrellado	e s t 4 e L a d o
estrenarse	e s t 4 e n a r s e
estrepitoso	e s t 4 e p i t o s o
estricta	e s t 4 i g t a
estricto	e s t 4 i g t o
estrofa	e s t 4 o f a
estrépito	e s t 4 e p i t o
estuario	e s t w a 4 j o
estudiando	e s t u D i a n d o
estudiar	e s t u D j a 4
estuve	e s t u b e
estuvieron	e s t u b j e 4 o n
estuvimos	e s t u b i m o s
estuviste	e s t u b i s t e
estuvisteis	e s t u b i s t e i s
estuvo	e s t u b o
está	e s t a
estábamos	e s t a b a m o s
estático	e s t a t i k o
estético	e s t e t i k o
estómago	e s t o m a g o
etapa	e t a p a
eucalipto	e u k a l i p t o
eucaristía	e u k a 4 i s t i a
euforia	e u f o 4 j a
evangelio	e B a N x e l j o
evangélico	e b a n x e l i k o
evasión	e b a s j o n
evo	e b o
evolución	e B o l u T j o n
examen	e g s a m e n
excelente	e k s e l e n t e
excelentemente	e k s e l e n t e m e n t e
excepto	e k s T e b t o
exclusivo	e k s k l u s i b o
exclusión	e k s k l u s j o n
excusa	e k s k u s a
exfoliante	e k s f o l j a n t e
expectoración	e k s p e g t o 4 a T j o n
exprimir	e k s p 4 i m i 4
exquisito	e k s k i s i t o
extender	e k s t e n d e 4
extensiva	e k s t e n s i b a
extensivamente	e k s t e n s i b a m e n t e
extensivas	e k s t e n s i b a s
extensivo	e k s t e n s i b o
extensivos	e k s t e n s i b o s
extinto	e k s t i n t o
extrañar	e s t 4 a J a 4
extraño	e k s t 4 a J o
eyaculación	e j\ a k u l a T j o n
eñes	e J e s
eólico	e o l i k o
f	e f e
fabuloso	f a b u l o s o
facha	f a tS a
facial	f a T j a l
facilidad	f a T i l i d a d
factura	f a g t u 4 a
facultad	f a k u l t a d
faena	f a e n a
faja	f a x a
falafel	f a l a f e l
falange	f a l a N x e
falda	f a l d a
fallar	f a L a 4
falles	f a L e s
falsedad	f a l s e d a d
falsificación	f a l s i f i k a s j o N
falsificar	f a l s i f i k a 4
faltar	f a l t a 4
familia	f a m i l j a
famoso	f a m o s o
famosísimo	f a m o s i s i m o
fango	f a N g o
fantasma	f a n t a s m a
fantasmagoría	f a n t a s m a g o 4 i a
faraón	f a 4 a o n
farmacia	f a r m a T j a
faro	f a 4 o
farol	f a 4 o l
farola	f a 4 o l a
farsa	f a r s a
fascismo	f a s T i s m o
fascista	f a s T i s t a
fastidiar	f a s t i d j a 4
fastidio	f a s t i D j o
fatídico	f a t i d i k o
favor	f a B o r
favorito	f a B o 4 i t o
fe	f e
febrero	f e b 4 e 4 o
fecha	f e tS a
felino	f e l i n o
feliz	f e l i T
feminicidio	f e m i n i T i D j o
fenómeno	f e n o m e n o
feo	f e o
feria	f e 4 j a
ferretería	f e r e t e 4 i a
fetiche	f e t i tS e
feísimo	f e i s i m o
fibra	f i b 4 a
fibrosis	f i b 4 o s i s
fiebre	f j e b 4 e
fiero	f j e 4 o
fierro	f j e r o
fijar	f i x a 4
filete	f i l e t e
filigrana	f i l i g 4 a n a
filipina	f i l i p i n a
filipinas	f i l i p i n a s
filipinos	f i l i p i n o s
filme	f i l m e
filo	f i l o
filología	f i l o l o x i a
filón	f i l o n
filósofo	f i l o s o f o
fin	f i n
fina	f i n a
final	f i n a l
finanza	f i n a n T a
finito	f i n i t o
fino	f i n o
finísimo	f i n i s i m o
flaco	f l a k o
flamenco	f l a m e n k o
flanco	f l a n k o
flatulencias	f l a t u l e n T j a s
flema	f l e m a
flexible	f l e k s i B l e
flojera	f l o x e 4 a
flor	f l o 4
floral	f l o 4 a l
florales	f l o 4 a l e s
flujo	f l u x o
flúor	f l u o 4
foca	f o k a
folleto	f o L e t o
foramen	f o 4 a m e n
forjar	f o r x a 4
formación	f O r m a T j o n
formar	f o r m a 4
formativa	f o r m a t i b a
foro	f o 4 o
forrarse	f o r a r s e
fortuna	f o r t u n a
forzoso	f o 4 s o s o
fotaza	f o t a T a
fotazas	f o t a T a s
foto	f o t o
fotogenia	f o t o x e n j a
fotografía	f o t o G 4 a f i a
fractal	f 4 a g t a l
fractura	f 4 a g t u 4 a
fracturar	f 4 a g t u 4 a 4
fragata	f 4 a g a t a
fraile	f 4 a j l e
frambuesa	f 4 a m b w e s a
francés	f 4 a n T e s
frase	f 4 a s e
frecuencia	f 4 e k w e n T j a
frente	f 4 e n t e
frenéticamente	f 4 e n e t i k a m e n t e
frijol	f r i x o l
friki	f 4 i k i
frondoso	f 4 o n d o s o
fruta	f 4 u t a
frágil	f 4 a x i l
fría	f 4 i a
frío	f 4 i o
fu	f u
fucsia	f u k s j a
fue	f w e
fuego	f w e G o
fuente	f w e n t e
fuera	f w e 4 a
fueran	f w e 4 a n
fueras	f w e 4 a s
fueron	f w e 4 o n
fuerte	f w e 4 t e
fuese	f w e s e
fugaz	f u G a T
fui	f w i
fuiste	f w i s t e
fulanito	f u l a n i t o
fumar	f u m a 4
fundador	f u n d a d o 4
funeral	f u n e 4 a l
funerario	f u n e 4 a 4 j o
fusil	f u s i l
fusilero	f u s i l e 4 o
futuro	f u t u 4 o
fuéramos	f w e 4 a m o s
fábrica	f a B 4 i k a
fácil	f a T i l
fácilmente	f a T i l m e n t e
fértil	f e 4 t i l
física	f i s i k a
físico	f i s i k o
fósforo	f o s f o 4 o
fósil	f o s i l
g	g
gabacha	g a b a tS a
gabacho	g a b a tS o
gaitero	g a i t e 4 o
galardón	g a l a r d o n
galaxia	g a l a g s j a
galgo	g a l g o
galáctico	g a l a g t i k o
galán	g a l a n
galón	g a l o n
ganar	g a n a 4
gancho	g a n tS o
ganso	g a n s o
garabato	g a 4 a B a t o
garbanzo	g a r b a n T o
garganta	G a 4 G a n t a
garra	g a r a
garrapata	g a r a p a t a
gas	g a s
gaseosa	g a s e o s a
gasoducto	g a s o d u g t o
gastrónomo	g a s t 4 o n o m o
gato	g a t o
gaviota	g a b j o t a
gay	g e i
gazapo	G a T a p o
gaélico	g a e l i k o
ge	x e
gel	x e l
gelatina	x e l a t i n a
gema	x e m a
gemelo	x e m e l o
gendarme	x e n d a r m e
genera	x e n e 4 a
generador	x e n e 4 a d o 4
general	x e n e 4 a l
generar	x e n e 4 a 4
genio	x e n j o
genoma	x e n o m a
gente	x e_~ n t e
gentileza	x e n t i l e T a
gerente	x e 4 e n t e
gerifalte	x e 4 i f a l t e
germano	x e r m a n o
gigante	x i g a n t e
gigantesco	x i G a n t e s k o
gilipollas	x i l i p o L a s
gilipollez	x i l i p o L e T
gime	x i m e
gimnasio	x i m n a s j o
gira	x i 4 a
giras	x i 4 a s
girasol	x i 4 a s o l
giro	x i 4 o
glamour	g l a m u 4
glamouroso	g l a m u 4 o s o
globo	g l o b o
glorieta	g l o 4 j e t a
gluten	g l u t e n
gobernación	g o B e 4 n a T j o n
gobernador	g o B e 4 n a D o 4
gobernar	g o B e 4 n a 4
gobierno	g o b j e r n o
gofio	g o f j o
goleada	g o l e a d a
gordita	g o r d i t a
gordito	g o r d i t o
gorrión	g o r j o n
gota	g o t a
gozar	g o T a 4
gozo	g o T o
grabadora	g 4 a b a d o 4 a
grabar	g 4 a b a 4
grabe	g 4 a b e
grabes	g 4 a b e s
grabo	g 4 a b o
gracia	g 4 a T j a
gracias	g 4 a T j a s
gracioso	g 4 a d s j o s o
grado	G 4 a D o
graficar	g 4 a f i k a 4
grafiti	g 4 a f i t i
grafito	g 4 a f i t o
gran	g 4 a n
granate	g 4 a n a t e
grande	g 4 a n d e
granero	g 4 a n e 4 o
granizo	g 4 a n i T o
granja	g r a N x a
grano	g 4 a n o
grapa	g 4 a p a
gravar	g 4 a b a 4
grave	g 4 a b e
gravedad	g 4 a b e d a d
graves	g 4 a b e s
gravilla	g 4 a B i L a
gremio	g 4 e m j o
grey	g r e j
grial	g 4 j a l
griego	g 4 j e g o
grillete	g 4 i j\ e t e
grillo	g 4 i L o
gringo	g 4 i n g o
gripe	G 4 i p e
gris	g r i s
griterío	g 4 i t e 4 i o
grosería	g 4 o s e 4 i a
grumo	g 4 u m o
grúa	g 4 u a
guacamole	g w a k a m o l e
guagua	w a w a
guanche	g w a n tS e
guante	g w a n t e
guapo	g w a p o
guardameta	g w a 4 D a m e t a
guarrada	g w a r a d a
guarro	g w a r o
guay	g w a i
guepardo	g e p a r d o
guerra	g e r a
guerrero	g E r E 4 o
guerrilla	g e r i L a
guerrillero	g e r i L e 4 o
guillotina	g i L o t i n a
guinda	g i n d a
guion	g i j o n
guisa	g i s a
guisante	g i s a n t e
guiso	g i s o
guitarra	g i t a r a
guitarrista	g i t a r i s t a
gurú	g u 4 u
gusanito	g u s a n i t o
gusano	g u s a n o
gustado	g u s t a d o
gustar	g u s t a 4
gusto	g u s t o
género	x e n e 4 o
génesis	x e n e s i s
h	a t S e
ha	a
haba	a b a
habanero	a b a n e 4 o
habano	a b a n o
haber	a b e 4
habita	a b i t a
habitable	a b i t a b l e
habitación	a b i t a T j o n
habitante	a b i t a n t e
habla	a b l a
hablado	a b l a d o
hablar	a b l a 4
hablo	a b l o
habéis	a B e j s
hace	a T e
hacemos	a T e m o s
hacen	a T e n
hacer	a T e 4
haces	a T e s
hache	a tS e
hacia	a T j a
haciendo	a T j e n d o
hackear	x a k e a 4
hacía	a T i a
hacías	a T i a s
hada	a d a
haga	a g a
hagamos	a g a m o s
hagan	a g a n
hagas	a g a s
hago	a g o
hai	a i
hala	a l a
hallar	a L a 4
hambre	a m b 4 e
hamburguesa	a m b u r g e s a
hamburguesería	a m b u r g e s e 4 i a
hamo	a m o
han	a n
haraquiri	a 4 a k i 4 i
haremos	a 4 e m o s
harina	a 4 i n a
harto	a 4 t o
hará	a 4 a
harán	a 4 a n
harás	a 4 a s
haré	a 4 e
haría	a 4 i a
harían	a 4 i a n
has	a s
hasta	a s t a
hawaiano	x a w a j a n o
hay	a i
haz	a T
hazmerreír	a T m e r e i 4
he	e
hebra	e b 4 a
hecha	e tS a
hechas	e tS a s
hechicero	e t S i T e 4 o
hechizo	e t S i T o
hecho	e tS o
hechos	e tS o s
hediondo	e d j o n d o
hegemonía	e x e m o n i a
helado	e l a d o
helicoide	e l i k o i d e
helio	e l j o
hematoma	e m a t o m a
hembra	e m b 4 a
hemisferio	e m i s f e 4 j o
hemorragia	e m o r a x j a
herbívoro	e r b i b o 4 o
heredero	e 4 e d e 4 o
herida	e 4 i D a
hermanastro	e r m a n a s t 4 o
hermandad	e r m a n d a d
hermoso	e r m o s o
hermosura	e 4 m o s u 4 a
hernia	e 4 n j a
heroína	e 4 o i n a
herrero	e r e 4 o
hervor	e r b o 4
heterosexualidad	e t e 4 o s e g s w a l i d a d
hez	e T
hice	i T e
hiciera	i T j e 4 a
hicimos	i T i m o s
hidalgo	i d a l g o
hidalguía	i d a l g i a
hidrógeno	i d 4 o x e n o
hielo	j e l o
hiena	J\j\ e n a
hierba	J\j\ e r b a
hierro	J\j\ e r o
higiene	i x j e n e
higo	i g o
higos	i G o s
hijito	i x i t o
hijo	i x o
hijueputa	i x w e p u t a
himno	i m n o
hinchar	i J t S a 4
hindú	i n d u
hipopótamo	i p o p o t a m o
hipotético	i p o t e t i k o
hipódromo	i p o d 4 o m o
hipótesis	i p o t e s i s
hispano	i s p a n o
histeria	i s t e 4 j a
historia	i s t o 4 j a
historiador	i s t o 4 j a d o 4
histérico	i s t e 4 i k o
histórico	i s t o 4 i k o
hitita	i t i t a
hizo	i T o
hockey	x o k i
hogar	o g a 4
hogaza	o G a T a
hoja	o x a
hojaldre	o x a l d 4 e
hola	o l a
holocausto	o l o k a u s t o
hombre	o m b 4 e
hombro	o m b 4 o
homenaje	o m e n a x e
homofobia	o m o f o b j a
homosexualidad	o m o s e g s w a l i d a d
honda	o n d a
hondas	o n d a s
hongkonés	h o N k o n e s
hongo	o n g o
honor	o n o 4
honorable	o n o 4 a b l e
horado	o 4 a d o
horario	o 4 a 4 j o
horchata	o r tS a t a
hormiguero	o r m i g e 4 o
hormona	o r m o n a
horno	o 4 n o
horror	o r o 4
horóscopo	o 4 o s k o p o
hospicio	o s p i T j o
hospitalidad	o s p i t a l i d a d
hostal	o s t a l
hotel	o t e l
hoy	o i
huachinango	w a tS i n a n g o
huela	w e l a
huele	w e l e
hueso	w e s o
hueste	w e s t e
hueva	w e B a
huevo	w e B o
huevón	w e B o_~ n
hule	u l e
humana	u m a n a
humano	u m a n o
humedecer	u m e d e T e 4
humillación	u m i L a T j o n
humillar	u m i L a 4
humo	u m o
hundir	u n d i 4
huracán	u 4 a k a n
huso	u s o
husos	u s o s
huy	u j
huya	u j\ a
hábil	a b i l
hámster	x a m s t e r
hélice	e l i T e
héroe	e 4 o e
híbrido	i B 4 i D o
hígado	i g a d o
húngaro	u N g a 4 o
i	i
iba	i b a
ice	i T e
iceberg	i T e B e 4
icono	i k o n o
iconoclasta	i k o n o k l a s t a
iconografía	i k o n o g 4 a f i a
idea	i d e a
idilio	i d i l j o
idioma	i D j o m a
idiota	i d j o t a
idiotez	i d j o t e T
idoneidad	i d o n e i d a d
idílico	i d i l i k o
idóneo	i d o n e o
iglesia	i g l e s j a
ignorante	i g n o 4 a n t e
igual	i g w a l
igualdad	i g w a l d a d
iguana	i g w a n a
ilegal	i l e g a l
ileso	i l e s o
ilícito	i l i T i t o
imagen	i m a x e n
imaginación	i m a x i n a T j o n
imbécil	i m b e T i l
impala	i m p a l a
implacable	i m p l a k a B l e
implacables	i m p l a k a b l e s
imponer	i m p o n e 4
imposible	i m p o s i b l e
imprescindible	i m p 4 e s T i n d i b l e
impusiese	i m p u s j e s e
imán	i m a n
incertidumbre	i n T e 4 t i D u m b 4 e
incienso	i n T j e n s o
incluso	i n k l u s o
incondicional	i n k o n d i T j o n a l
inconveniente	i n k o m b e n j e n t e
increíble	i n k 4 e i b l e
incriminar	i n k 4 i m i n a 4
indefinido	i n d e f i n i d o
individuo	i n d i b i d w o
indonesio	i n d o n e s j o
inefable	i n e f a B l e
infección	i F f e k T j o n
infernal	i n f e r n a l
infierno	i n f j e r n o
infinitivo	i n f i n i t i B o
inflamable	i n f l a m a b l e
infligir	i n f l i x i 4
inflorescencia	i n f l o 4 e s T e n T j\ a
influido	i n f l w i d o
información	i m f o 4 m a T j o n
informática	i n f o 4 m a t i k a
infraccionar	i n f 4 a g T j o n a 4
ingeniero	i N x e n j e 4 o
ingerir	i n x e 4 i 4
ingles	i n g l e s
inglés	i n g l e s
inhóspito	i n o s p i t o
iniciar	i n i T j a 4
inicuo	i n i k w o
injustificable	i n x u s t i f i k a b l e
inmoralidad	i m m o 4 a l i d a d
inmune	i n m u n e
innombrable	i n n o m b 4 a b l e
innovación	i n n o b a T j o n
inquilino	i n k i l i n o
inquisición	i n k i s i T j o n
insonorizar	i n s o n o 4 i T a 4
inspector	i n s p e g t o 4
instar	i n s t a 4
instaurar	i n s t a u 4 a 4
instintiva	i n s t i n t i b a
instinto	i n s t i n t o
instrucción	i n s t 4 u k T j o n
insulso	i n s u l s o
insumo	i n s u m o
insurgente	i n s u 4 X e n t e
intangible	i n t a n x i b l e
integral	i n t e g 4 a l
inteligente	i n t e l i x e n t e
intendencia	i n t e n d e n T j a
interesante	i n t e 4 e s a n t e
intermediar	i n t e r m e d j a 4
internet	i n t e 4 n e t
intersticial	i n t e r s t i T j a l
interviú	i n t e r b j u
intocable	i n t o k a B l e
intuición	i n t w i T j o n
invención	i m b e n T j o n
invernadero	i m b e r n a d e 4 o
inversión	i F b e 4 s j o n
invertir	i F b e 4 t i 4
invierno	i m b j e 4 n o
inyección	i n j\ e k T j o n
inyectar	i n j\ e k t a 4
inédito	i n e d i t o
inútil	i n u t i l
ion	j o n
iota	i o t a
ir	i 4
ira	i 4 a
iraquí	i 4 a k i
iridio	i 4 i D j o
irreconciliable	i r e k o n s i l j a v l e
irresistible	i r e s i s t i b l e
irreversible	i r e b e r s i b l e
irritar	i r i t a 4
irá	i 4 a
iré	i 4 e
iría	i 4 i a
isla	i s l a
islam	i z l a m
islámico	i s l a m i k o
iza	i T a
izar	i T a 4
izquierda	i T k j e 4 D a
j	x
ja	x a
jabalina	x a b a l i n a
jabón	x a b o n
jaca	x a k a
jacinto	x a T i n t o
jaco	x a k o
jade	x a D e
jaja	x a x a
jajaja	x a x a x a
jamaica	x a m a i k a
jamás	x a m a s
jamón	x a m o n
japonesa	x a p o n e s a
japonés	x a p o n e s
jaque	x a k e
jardín	x a 4 D i n
jauría	x a u 4 i a
jazmín	x a T m i n
jazz	J\j\ a s
jeans	j i n s
jengibre	x e n x i b 4 e
jerarquía	x e 4 a r k i a
jerez	x e 4 e T
jerga	x e r g a
jeringa	x e 4 i N g a
jersey	x e r s e j
jesuita	x e s w i t a
jeta	x e t a
ji	x i
jinete	x i n e t e
jo	x o
joder	x o D e 4
jodiendo	x o D j e_~ n d o
jonrón	x o n r o n
jota	x o t a
jotas	x o t a s
joven	x o b e n
jovial	x o b j a l
joystick	tS o i s t i g
judas	x u d a s
judaísmo	x u d a i s m o
judicializar	x u d i T j a l i T a 4
judo	j\ u D o
judía	x u d i a
jueves	x w e b e s
juez	x w e T
jugar	x u g a 4
juglar	x u g l a 4
jugo	x u g o
juguete	x u g e t e
jugás	x u g a s
juicio	x w i T j o
julio	x u l j o
junco	x u n k o
jungla	x u n g l a
junio	x u n j o
junta	x u n t a
juntar	x u n t a 4
junto	x u n t o
jura	x u 4 a
juvenil	x u b e n i l
juventud	x u b e n t u d
juzgado	x u T g a d o
juzgar	x u T g a 4
k	k
ka	k a
kafkiano	k a f k j a n o
kamikaze	k a m i k a T e
karaoke	k a 4 a o k e
karate	k a 4 a t e
karma	k a r m a
ketchup	k e d tS u b
kilometraje	k i l o m e t 4 a x e
kilos	k i l o s
kilómetro	k i l o m e t 4 o
kimono	k i m o n o
kiwi	k i w i
koala	k o a l a
kurdo	k u r d o
kínder	k i n d e 4
l	l
la	l a
labial	l a b j a l
labrar	l a b 4 a 4
laburo	l a b u 4 o
lacar	l a k a 4
lacio	l a T j o
lacrimógeno	l a k 4 i m o x e n o
lactancia	l a k t a n T j a
lago	l a g o
lamentable	l a m e n t a b l e
lanza	l a n T a
lao	l a o
lapa	l a p a
las	l a s
lasaña	l a s a J a
lata	l a t a
laudo	l a u d o
lavadora	l a B a D o 4 a
lavanda	l a b a n d a
laves	l a b e s
lazo	l a T o
leal	l e a l
leche	l e t S e
lechuza	l e t S u T a
leer	l e e 4
legal	l e g a l
legislar	l e x i s l a 4
legislativo	l e x i s l a t i B o
lejos	l e x o s
lengua	l e n g w a
lenguaje	l e N g w a x e
leona	l e o n a
leopardo	l e o p a r d o
lepra	l e p 4 a
letal	l e t a l
letanía	l e t a n i a
letrero	l e t 4 e 4 o
leucemia	l e u T e m j a
levar	l e b a 4
leve	l e b e
levedad	l e b e d a d
ley	l e i
leyenda	l e J\j\ e n d a
leña	l e J a
león	l e o n
liana	l j a n a
liaré	l j a 4 e
libertad	l i b e r t a d
libertario	l i b e r t a 4 j o
libra	l i b 4 a
libre	l i b 4 e
libro	l i b 4 o
lichi	l i tS i
licor	l i k o 4
licores	l i k o 4 e s
lid	l i d
liebre	l j e B 4 e
liga	l i g a
ligado	l i g a d o
ligamento	l i g a m e n t o
ligereza	l i x e 4 e T a
light	l a i t
lila	l i l a
lima	l i m a
limbo	l i m b o
limite	l i m i t e
limites	l i m i t e
limonero	l i m o n e 4 o
limosna	l i m o s n a
limpio	l i m p j o
limusina	l i m u s i n a
linaje	l i n a x e
lince	l i n T e
lio	l i o
lira	l i 4 a
lirón	l i 4 o n
literatura	l i t e 4 a t u 4 a
litio	l i t j o
litro	l i t 4 o
liturgia	l i t u r x j a
litúrgico	l i t u r x i k o
llama	L a m a
llamar	L a m a 4
llano	L a n o
llanos	L a n o s
llanta	L a n t a
llave	j\ a B e
llegar	L e g a 4
llenar	L e n a 4
llevar	J\ e B a 4
llorando	L o 4 a n d o
llorar	L o 4 a 4
llover	L o B e 4
lluvia	L u B j a
lluvioso	L u b j o s o
lo	l o
lobo	l o B o
loca	l o k a
locamente	l o k a m e_~ n t e
locas	l o k a s
loco	l o k o
locos	l o k o s
locura	l o k u 4 a
locutor	l o k u t o 4
lodazal	l o d a T a l
logia	l o x j a
lograr	l o g 4 a 4
loma	l o m a
lomo	l o m o
longitudinal	l o n x i t u d i n a l
lord	l o 4 D
los	l o s
loto	l o t o
lucero	l u T e 4 o
lucha	l u tS a
lucia	l u T j a
lucía	l u T i a
luego	l w e g o
lugar	l u g a 4
lujo	l u x o
lumbre	l u m b 4 e
lumbrera	l u m b 4 e 4 a
luminoso	l u m i n o s o
lumínico	l u m i n i k o
luna	l u n a
lunar	l u n a 4
lunes	l u n e s
luneta	l u n e t a
lustre	l u s t 4 e
lustro	l u s t 4 o
luz	l u T
lácteo	l a g t e o
lágrima	l a G 4 i m a
lámina	l a m i n a
lápida	l a p i d a
lápiz	l a p i T
lícito	l i T i t o
líder	l i d e 4
línea	l i n e a
lío	l i o
lóbulo	l o b u l o
lúdica	l u d i k a
m	m
macaca	m a k a k a
macaco	m a k a k o
macana	m a k a n a
macarrón	m a k a r o n
machete	m a t S e t e
macizo	m a T i T o
maco	m a k o
madeja	m a d e x a
madera	m a d e 4 a
madre	m a D r e
madrileño	m a d 4 i l e J o
madrina	m a d 4 i n a
madroño	m a d 4 o J o
madrugada	m a d 4 u g a d a
maduro	m a D u 4 o
maeso	m a e s o
maestro	m a e s t 4 o
magia	m a x j a
magnate	m a g n a t e
magnificar	m a g n i f i k a 4
magno	m a g n o
mago	m a g o
magro	m a M\ 4 o
mahometano	m a o m e t a n o
mahonesa	m a o n e s a
maicena	m a i T e n a
mail	m e i l
maje	m a x e
majo	m a x o
mal	m a l
mala	m a l a
malabarista	m a l a b a 4 i s t a
maldición	m a l d i T j o n
malecón	m a l e k o n
males	m a l e s
malinterpretar	m a l i n t e 4 p 4 e t a 4
malo	m a l o
malvavisco	m a l B a B i s k o
mamada	m a m a D a
mamar	m a m a 4
mamarracho	m a m a r a tS o
mamut	m a m u t
mamá	m a m a
mana	m a n a
manchar	m a n t S a 4
mancomunidad	m a n k o m u n i D a D
mandarín	m a n D a 4 i n
mandatario	m a n d a t a 4 j o
mandil	m a n d i l
manejar	m a n e x a 4
manes	m a n e s
mango	m a n g o
manifiesto	m a n i f j e s t o
maniático	m a n j a t i c o
manjar	m a n x a 4
mano	m a_~ n o
manojo	m a n o x o
manso	m a n s o
mantequilla	m a n t e k i L a
mantra	m a n t 4 a
manual	m a n w a l
manualidad	m a n w a l i d a d
manzana	m a n T a n a
maná	m a n a
maníaco	m a n i a k o
mapache	m a p a t S e
maqueta	m a k e t a
maquetar	m a k e t a 4
maquillar	m a k i L a 4
maquinaria	m a k i n a r j a
maquinilla	m a k i n i L a
mar	m a 4
maratón	m a 4 a t o n
maravilla	m a 4 a b i L a
marcha	m a 4 tS a
marchar	m a 4 tS a 4
marché	m a 4 t S e
marco	m a 4 k o
maremoto	m a 4 e m o t o
marfil	m a 4 f i l
margarita	m a r g a 4 i t a
mariachi	m a 4 j a t S i
maricón	m a 4 i k o n
marihuana	m a 4 i w a n a
marioneta	m a 4 j o n e t a
mariposa	m a r i p o s a
mariquita	m a r i k i t a
marqué	m a 4 k e
marqués	m a 4 k e s
marrano	m a r a n o
marrón	m a r o n
martes	m a r t e s
martillo	m a 4 t i j\ o
marzo	m a r T o
mas	m a s
masculinidad	m a s k u l i n i D a D
masturbación	m a s t u 4 b a s j o n
mastín	m a s t i n
mataburros	m a t a b u r o s
matan	m a t a n
matemática	m a t e m a t i k a
matemáticas	m a t e m a t i k a s
matemático	m a t e m a t i k o
maternal	m a t e r n a l
mates	m a t e s
matriz	m a t 4 i T
matón	m a t o_~ n
mayo	m a J\j\ o
mayonesa	m a J\j\ o n e s a
mayor	m a j\ o r
maíz	m a i T
maña	m a J a
mañana	m a J a n a
me	m e
mecha	m e tS a
mechón	m e tS o n
medida	m e d i d a
medieval	m e D i e B a l
medir	m e d i 4
meditar	m e d i t a 4
medular	m e d u l a 4
megafonía	m e g a f o n i a
mejicana	m e x i k a_~ n a
mejilla	m e x i L a
mejor	m e x o 4
mejorar	m e x o 4 a 4
melafo	m e l a f o
melancolía	m e l a N k o l i a
melancólico	m e l a N k o l i k o
melena	m e l e n a
mellizo	m e L i T o
melocotón	m e l o k o t o n
melodía	m e l o D i a
membrana	m e m b 4 a n a
memo	m e m o
menopausia	m e n o p a u s j a
menos	m e n o s
mensaje	m e n s a x e
mensajero	m e n s a x e 4 o
menso	m e n s o
mensual	m e n s w a l
menta	m e n t a
mente	m e n t e
menudo	m e_~ n u D o
menú	m e n u
mercadería	m e r k a d e 4 i a
mercado	m e 4 k a d o
mercadotecnia	m e 4 k a D o t e k n j a
mercantil	m e 4 k a n t i l
merced	m e 4 T e D
mercurio	m e 4 k u 4 j o
meridiano	m e 4 i D j a n o
merienda	m e 4 j e n d a
merino	m e 4 i n o
mermelada	m e r m e l a d a
mes	m e s
mesa	m e s a
mesero	m E s E 4 o
mesiversario	m e s i b e r s a 4 j o
mestizo	m e s t i T o
mesuradamente	m e s u 4 a d a m e n t e
mesón	m e s o n
metafísica	m e t a f i s i k a
metamorfosis	m e t a m o 4 f o s i s
metanfetamina	m e t a n f e t a m i n a
meteoro	m e t e o 4 o
meter	m e t e 4
mexica	m e x i k a
mexicano	m e x i k a n o
mexicanos	m e x i k a n o s
mezquita	m e T k i t a
mi	m i
michoacano	m i tS o a k a n o
microbio	m i k 4 o b j o
mida	m i D a
mide	m i D e
miedo	m j e d o
miel	m j e l
miembro	m j e m b 4 o
mientras	m j e n t 4 a s
mierda	m j e 4 d a
mies	m j e s
miga	m i G a
migraña	m i G 4 a J a
mija	m i x a
mijo	m i x o
mil	m i l
milagro	m i l a g 4 o
milicia	m i l i T j a
militar	m i l i t a 4
millón	m i L o n
mina	m i n a
mineral	m i n e 4 a l
minero	m i n e 4 o
ministra	m i n i s t 4 a
minúsculo	m i n u s k u l o
mirad	m i 4 a d
mirada	m i 4 a D a
mirar	m i 4 a 4
mis	m i s
misionero	m i s j o n e 4 o
mismas	m i s m a s
mismo	m i s m o
mismos	m i s m o s
misoginia	m i s o x i n j a
miss	m i s
misterio	m i s t e 4 j o
mitad	m i t a d
mitin	m i t i n
mitos	m i t o s
mitín	m i t i n
miércoles	m j e r k o l e s
mocho	m o t S o
moda	m o D a
modelismo	m o d e l i s m o
modelo	m o d e l o
modernista	m o d e r n i s t a
mofeta	m o f e t a
mogollón	m o g o L o n
moisés	m o j s e s
moja	m o x a
mojado	m o x a D o
mojar	m o x a r
mojito	m o x i t o
mojo	m o x o
mojos	m o x o s
molar	m o l a 4
moldeado	m o l d e a d o
moldear	m o l d e a 4
molicie	m o l i T j e
mollera	m o L e 4 a
molusco	m o l u s k o
mona	m o n a
monarca	m o n a r k a
monarquía	m o n a 4 k i a
monas	m o n a s
monasterio	m o n a s t e 4 j o
mondo	m o n d o
moneda	m o n e d a
monogamia	m o n o G a m j a
monos	m o n o s
montaje	m o n t a x e
montaña	m o n t a J a
monte	m o n t e
montón	m o n t o n
monzón	m o n T o n
moral	m o 4 a l
morcilla	m o 4 T i L a
morena	m o 4 e n a
morir	m o 4 i 4
morro	m o r o
mortandad	m o 4 t a n d a D
mortuorio	m o 4 t w o 4 j o
morís	m o 4 i s
mosca	m o s k a
moscovita	m o s k o b i t a
mosquito	m o s k i t o
mostaza	m o s t a T a
mostrar	m o s t 4 a 4
mota	m o t a
motocicleta	m o t o T i k l e t a
mozo	m o T o
moño	m o J o
muchedumbre	m u t S e d u m b r e
mucho	m u tS o
mudo	m u D o
muela	m w e l a
muelle	m w e L e
muerte	m w e 4 t e
muesli	m w e s l i
mujer	m u x e 4
mula	m u l a
multicultural	m u l t i k u l t u 4 a l
mulá	m u l a
mundano	m u n d a n o
mundo	m u n d o
municipal	m u n i s i p a l
murciélago	m u 4 T j e l a g o
muro	m u 4 o
musa	m u s a
muscular	m u s k u l a 4
museo	m u s e o
musical	m u s i k a l
muslo	m u s l o
mutual	m u t w a l
mutuo	m u t w o
muy	m w i
mácula	m a k u l a
mágico	m a x i k o
máquina	m a k i n a
mármol	m a 4 m o l
más	m a s
máster	m a s t e 4
médico	m e d i k o
médula	m e d u l a
mía	m i a
mías	m i a s
mío	m i o
míos	m i o s
místico	m i s t i k o
mítico	m i t i k o
módem	m o D e m
módico	m o D i k o
músculo	m u s k u l o
música	m u s i k a
n	n
nabo	n a B o
nace	n a T e
nacer	n a T e 4
nacho	n a tS o
nacido	n a T i d o
nacimiento	n a T i m j e n t o
nacionalsocialismo	n a T j o n a l s o T j a l i s m o
nació	n a T j o
nací	n a T i
nada	n a d a
nadal	n a d a l
nadar	n a d a 4
nadie	n a d j e
nalga	n a l g a
nalgada	n a l g a d a
nana	n a n a
nano	n a n o
napolitano	n a p o l i t a n o
naranja	n a 4 a N x a
narco	n a r k o
nariz	n a 4 i T
narrador	n a r a d o 4
narradora	n a r a d o 4 a
natal	n a t a l
natalicio	n a t a l i T j o
natillas	n a t i L a s
nativo	n a t i b o
naturaleza	n a t u 4 a l e T a
naturalidad	n a t u 4 a l i D a D
naturalmente	n a t u 4 a l m e_~ n t e
navaja	n a B a x a
naval	n a b a l
nave	n a b e
navegabilidad	n a b e g a b i l i d a d
navegación	n a b e g a T j o n
nazi	n a T i
nazismo	n a T i z m o
necesario	n e T e s a 4 j o
necesidad	n e T e s i D a D
necesitar	n e T e s i t a 4
necio	n e T j o
nefario	n e f a 4 j o
nefasto	n e f a s t o
negligencia	n e g l i x e n T j a
negra	n e g 4 a
negrita	n e g 4 i t a
negro	n e g 4 o
negrura	n e g 4 u 4 a
neoyorquino	n e o J\j\ o r k i n o
networking	n e d w o r k i n g
neutralización	n e u t 4 a l i T a T j o_~ n
neutro	n e u t 4 o
nevada	n e B a D a
nevado	n e B a D o
nevar	n e B a 4
neón	n e o n
ni	n i
nicotina	n i k o t i n a
nido	n i D o
nieto	n j e t o
nimiedad	n i m j e d a d
ninguna	n i n g u n a
ninguno	n i n g u n o
ningún	n i N g u n
nini	n i n i
nipón	n i p o n
nitrógeno	n i t 4 o x e n o
niño	n i J o
no	n o
noche	n o tS e
nodriza	n o d 4 i T a
noes	n o e s
nombre	n o m b 4 e
nominativo	n o m i n a t i B o
nop	n o p
noria	n o 4 j a
norma	n o r m a
normativa	n o r m a t i b a
normativas	n o r m a t i b a s
norte	n o r t e
nosotras	n o s o t 4 a s
nosotros	n o s o t 4 o s
nostalgia	n o s t a l x j a
noticia	n o t i T j a
novedad	n o B e D a D
noventa	n o b e n t a
noviembre	n o b j e m b 4 e
novio	n o b j o
nublado	n u B l a D o
nuca	n u k a
nudo	n u D o
nuera	n w e 4 a
nuestra	n w e s t 4 a
nuestras	n w e s t 4 a s
nuestros	n w e s t 4 o s
nuevamente	n w e B a m e_~ n t e
nueve	n w e b e
nuevo	n w e B o
nuez	n w e T
nulidad	n u l i d a d
numen	n u m e n
numero	n u m e r o
nunca	n u N k a
nutria	n u t 4 j a
ná	n a
náusea	n a u s e a
náutico	n a u t i k o
néctar	n e k t a 4
níquel	n i k e l
nítido	n i t i D o
nómada	n o m a D a
número	n u m e r o
o	o
oasis	o a s i s
obispo	o B i s p o
obrar	o b 4 a 4
obscuro	o B s k u 4 o
obsoleto	o B s o l e t o
obvio	o b j o
oca	o k a
ocaso	o k a s o
occidente	o k T i D e n t e
ochenta	o tS e n t a
ocho	o tS o
ochocientos	o tS o T j e n t o s
ocre	o k 4 e
ocultar	o k u l t a 4
ocupación	o k u p a T j o n
ocurrente	o k u r e n t e
ocurrir	o k u r i 4
oda	o D a
odio	o d j o
oes	o e s
oeste	o e s t e
oficial	o f i T j a l
ofidio	o f i D j o
oh	o
oiga	o j G a
oigo	o j g o
ojalá	o x a l a
ojera	o x e 4 a
ojo	o x o
ojos	o x o s
okay	o k e j
ola	o l a
oligarca	o l i g a r k a
oligarquía	o l i G a 4 k i a
olimpiada	o l i m p j a D a
olio	o l j o
olivo	o l i B o
olla	o L a
olmo	o l m o
ombligo	o m b l i G o
once	o n T e
oncología	o N k o l o x i a
ondas	o n d a s
onza	o n T a
opción	o p T j o n
operar	o p e 4 a 4
opio	o p j o
oponer	o p o n e 4
optar	o p t a 4
ora	o 4 a
oración	o r a T j o n
orado	o 4 a d o
orar	o 4 a 4
orca	o 4 k a
orden	o 4 d e n
oreja	o 4 e x a
organismo	o 4 G a n i z m o
organizar	o r g a n i T a 4
organizaremos	o 4 G a n i T a 4 e m o s
orgasmo	o 4 G a s m o
orgullo	o 4 g u L o
oribe	o 4 i B e
origami	o 4 i g a m i
origen	o 4 i x e n
origine	o 4 i x i n e
ornitorrinco	o 4 n i t o r i N k o
oro	o 4 o
orografía	o 4 o G 4 a f i a
oros	o 4 o s
orquesta	o 4 k e s t a
ortodoxia	o 4 t o D o k s j a
ortodoxo	o 4 t o D o k s o
ortografía	o 4 t o g 4 a f i a
orégano	o 4 e G a n o
os	o s
osa	o s a
oscurito	o s k u 4 i t o
oscuro	o s k u 4 o
osezno	o s e T n o
oso	o s o
ostentación	o s t e n t a T j o n
ostión	o s t j o n
otaku	o t a k u
otero	o t e 4 o
otoñal	o t o J a l
otoño	o t o J o
otra	o t 4 a
otras	o t 4 a s
otro	o t 4 o
otrora	o t 4 o 4 a
otros	o t 4 o s
ovación	o b a T j o n
ovario	o b a 4 j o
oveja	o B e x a
ovni	o b n i
oxígeno	o k s i x e n o
oye	o J\j\ e
ozono	o T o n o
oído	o i d o
oír	o i 4
p	p
pabellón	p A B e L o n
paca	p a k a
paces	p a T e s
pacifica	p a T i f i k a
pacifico	p a T i f i k o
pacificó	p a T i f i k o
pacífica	p a T i f i k a
pacífico	p a T i f i k o
padre	p a D 4 e
padrenuestro	p a D 4 e n w e s t 4 o
paella	p a e L a
pagar	p a g a 4
pago	p a g o
paja	p a x a
pajarita	p a x a 4 i t a
pajarito	p a x a 4 i t o
pajero	p a x e 4 o
palabra	p a l a B 4 a
palazzo	p a l a t s o
palidecer	p a l i D e T e 4
palito	p a l i t o
palma	p a l m a
palmera	p a l m e 4 a
paloma	p a l o m a
palomino	p a l o m i n o
palomita	p a l o m i t a
pan	p a n
panadería	p a n a D e 4 i a
panda	p a n d a
panera	p a n e 4 a
panorama	p a n o 4 a m a
pantalla	p a n t a L a
pantalones	p a n t a l o n e s
pantalón	p a n t a l o n
pantera	p a_~ n t e 4 a
panteísmo	p a n t e i s m o
pantorrilla	p a n t o r i L a
panzón	p a n T o n
papa	p a p a
papado	p a p a D o
papamóvil	p a p a m o B i l
paparazzi	p a p a 4 a t s i
papaya	p a p a j\ a
papel	p a p e l
papiro	p a p i 4 o
papiroflexia	p a p i 4 o f l e g s j a
papá	p a p a
para	p a 4 a
paracaidista	p a 4 a k a i d i s t a
paradoja	p a 4 a D o x a
paraguas	p a 4 a g w a s
paralelo	p a 4 a l e l o
paralizar	p a 4 a l i T a 4
paranoia	p a 4 a n o j a
paranoico	p a 4 a n o j k o
paraíso	p a 4 a i s o
pardo	p a 4 D o
parecer	p a 4 e T e 4
pared	p a 4 e D
paros	p a 4 o s
parra	p a r a
parroquia	p a r o k j a
parte	p a 4 t e
participar	p a r t i T i p a 4
parábola	p a 4 a B o l a
paréntesis	p a 4 e n t e s i s
paró	p a 4 o
pasa	p a s a
pasajero	p a s a x e 4 o
pasar	p a s a 4
pascual	p a s k w a l
pasear	p a s e a 4
paseo	p a s e o
pasión	p a s j o n
paso	p a s o
paste	p a s t e
pastel	p a s t e l
pastilla	p a s t i L a
pastizal	p a s t i T a l
pastor	p a s t o 4
pastura	p a s t u 4 a
patata	p a t a t a
patente	p a t e n t e
patinar	p a t i n a 4
patrulla	p a t 4 u L a
patrullar	p a t 4 u L a 4
patético	p a t e t i k o
patín	p a t i n
pauta	p a u t a
pavor	p a B o 4
payaso	p a J\ j\ a s o
paz	p a T
pazo	p a T o
país	p a i s
paño	p a J o
pe	p e
pecado	p e k a D o
pecan	p e k a n
pecar	p e k a 4
pecarí	p e k a 4 i
pecera	p e T e 4 a
pecho	p e t S o
pechuga	p e tS u g a
pecorino	p e k o 4 i n o
pedagogía	p e D a G o x i a
pedante	p e D a n t e
pedantería	p e D a n t e 4 i a
pedernales	p e d e r n a l e s
pedestal	p e d e s t a l
pediatría	p e D j a t 4 i a
peinar	p e i n a 4
pelagatos	p e l a M\ a t o s
pelear	p e l e a 4
pelearse	p e l e a 4 s e
peligro	p e l i g 4 o
peligroso	p e l i g 4 o s o
pellejo	p e L e x o
pelo	p e l o
pelotari	p e l o t a 4 i
peluca	p e l u k a
peluche	p e l u tS e
peluquero	p e l u k e 4 o
película	p e l i k u l a
penal	p e n a l
pendeja	p e n d e x a
pendejo	p e n d e x o
pendón	p e n d o n
pene	p e n e
pensador	p e n s a D o 4
pentagrama	p e n t a g 4 a m a
pentágono	p e n t a G o n o
penuria	p e n u 4 j a
penúltimo	p e n u l t i m o
peonía	p e o n i a
peque	p e k e
peques	p e k e s
pequeño	p e k e J o
percha	p e r tS a
perdonar	p e r d o n a 4
perdón	p e 4 D o_~ n
perejil	p e 4 e x i l
perfecto	p e r f e g t o
perfume	p e r f u m e
periferia	p e 4 i f e 4 j a
periodo	p e 4 j o D o
periscopio	p e 4 i s k o p j o
perjuicio	p e 4 x w i T j o
perla	p e 4 l a
pero	p e 4 o
perro	p e r o
persa	p e r s a
persona	p e 4 s o n a
personal	p e 4 s o n a l
perspicaz	p e 4 s p i k a T
pertinaz	p e 4 t i n a T
peruano	p e 4 w a n o
pes	p e s
pescado	p e s k a D o
pescuezo	p e s k w e T o
pesebre	p e s e B 4 e
peso	p e s o
pesos	p e s o s
pestañear	p e s t a J e a 4
pestillo	p e s t i L o
pesto	p e s t o
pete	p e t e
peto	p e t o
pez	p e T
pezones	p e s o n e s
pezón	p e T o n
piano	p j a n o
picada	p i k a d a
picar	p i k a 4
picardía	p i k a 4 d i a
pico	p i k o
picotear	p i k o t e a 4
picoteo	p i k o t e o
pide	p i D e
pie	p j e
piedra	p j e D 4 a
pierna	p j e r n a
piernas	p j e r n a s
pimienta	p i m j e n t a
pimiento	p i m j e n t o
pinchar	p i n tS a 4
pinche	p i n t S e
pincho	p i n tS o
pinga	p i n g a
pingüino	p i N g w i n o
pintalabios	p i n t a l a B j o s
pintar	p i n t a 4
pinto	p i n t o
pinzón	p i n T o n
piojo	p j o x o
pipa	p i p a
piques	p i k e s
piquete	p i k e t e
pirata	p i 4 a t a
pirotecnia	p i 4 o t e k n j a
pirámide	p i 4 a m i D e
pis	p i s
pisar	p i s a 4
piscina	p i s T i n a
piso	p i s o
pistacho	p i s t a t S e
pitón	p i t o n
pivotar	p i b o t a 4
pizarra	p i T a r a
pizarrón	p i T a r o n
pizzería	p i T e 4 i a
piña	p i J a
piñata	p i J a t a
piñón	p i J o n
placa	p l a k a
placentero	p l a T e n t e 4 o
placer	p l a T e 4
plaf	p l a f
plan	p l a n
plancha	p l a n tS a
plancton	p l a N k t o n
planeta	p l a n e t a
planetario	p l a n e t a 4 j o
plano	p l a n o
plataforma	p l a t a f o 4 m a
platina	p l a t i n a
platino	p l a t i n o
plato	p l a t o
playa	p l a J\j\ a
playas	p l a j a s
plaza	p l a d s a
plazo	p l a T o
plebe	p l e B e
plebeyo	p l e B e j\ o
pleno	p l e n o
pletórico	p l e t o 4 i k o
plomo	p l o m o
pluma	p l u m a
plural	p l u 4 a l
plutonio	p l u t o n j o
plácido	p l a T i d o
población	p o B l a T j o n
poción	p o d s j o n
podemos	p o D e m o s
poder	p o d e 4
poderío	p o D e 4 i o
podredumbre	p o D 4 e D u m b 4 e
poema	p o e m a
poesía	p o e s i a
poeta	p o e t a
polca	p o l k a
polen	p o l e n
poli	p o l i
policía	p o l i T i a
poligamia	p o l i G a m j a
polilla	p o l i L a
polio	p o l j o
polis	p o l i s
polla	p o L a
pollo	p o L o
polo	p o l o
polvorón	p o l b o 4 o n
polímero	p o l i m e 4 o
pompa	p o m p a
poncho	p o J t S o
poner	p o n e 4
pontífice	p o n t i f i T e
popurrí	p o p u r i
por	p o 4
porfa	p o 4 f a
pornografía	p o 4 n o G 4 a f i a
pornográfico	p o 4 n o G 4 a p\ i k o
poro	p o 4 o
poroto	p o 4 o t o
porque	p o r k e
portavasos	p o r t a b a s o s
poseer	p o s e e 4
posguerra	p o s g e r a
poso	p o s o
postal	p o s t a l
posterior	p o h t e 4 j o 4
potable	p o t a b l e
potaje	p o t a x e
pozo	p o T o
prado	p 4 a D o
preceder	p 4 e T e D e r
precisión	p 4 e T i s j o n
preciso	p 4 e T i s o
precuela	p 4 e k w e l a
predecesor	p 4 e D e T e s o 4
predilección	p 4 e D i l e k s j o n
preferido	p 4 e f e 4 i D o
prefijo	p 4 e f i x o
pregunta	p 4 e g u n t a
preguntar	p 4 e G u_~ n t a 4
premio	p 4 e m j o
preparatorio	p 4 e p a 4 a t o 4 j o
preste	p r e s t e
prestigioso	p 4 e h t i x j o s o
prevenir	p 4 e B e n i 4
primavera	p 4 i m a B e 4 a
primaveras	p 4 i m a B e 4 a s
primera	p 4 i m e 4 a
primero	p 4 i m e 4 o
primitivo	p 4 i m i t i b o
principiante	p 4 i n T i p j a n t e
principio	p 4 i n T i p j o
prisa	p 4 i s a
prisión	p 4 i s j o n
prisma	p 4 i s m a
probable	p 4 o b a b l e
problema	p 4 o b l e m a
problemilla	p 4 o B l e m i L a
procedencia	p 4 o T e d e n T j a
procesión	p 4 o T e s j o n
proceso	p 4 o T e s o
proclive	p 4 o k l i B e
producimos	p 4 o d u T i m o s
producir	p 4 o D u T i 4
productor	p 4 o D u k t o 4
producía	p 4 o d u T i a
produjo	p 4 o d u x o
produzco	p 4 o d u T k o
proeza	p 4 o e T a
profeta	p r o f e t a
programador	p 4 o g 4 a m a d o 4
prolongar	p 4 o l o n g a 4
promocional	p 4 o m o T j o n a l
pronuncia	p 4 o n u n T j a
pronunciaciones	p 4 o n u n T i a T i o n e s
pronunciación	p 4 o n u n T j a T j o n
pronunciamiento	p 4 o n u n T i a m i e n t o
pronunciar	p 4 o n u n T j a 4
propensión	p r o p e n s j o n
propenso	p 4 o p e n s o
propiedad	p 4 o p j e d a d
prosa	p 4 o s a
prosperidad	p r o s p e 4 i D a D
prostitución	p 4 o s t i t u T j\ o n
prostituta	p 4 o s t i t u t a
protección	p 4 o t e k T j o n
protector	p 4 o t e g t o 4
proteger	p 4 o t e h e 4
provecho	p 4 o B e t S o
provisional	p 4 o b i s j o n a l
proyecto	p 4 o j\ e k t o
pródigo	p 4 o d i g o
próstata	p 4 o s t a t a
próximo	p 4 o k s i m o
psicodelia	s i k o D e l j a
psicodélico	s i k o D e l i k o
psicología	s i k o l o x i a
psicópata	s i k o p a t a
psique	s i k e
psoriasis	p s o 4 j a s i s
psíquico	s i k i k o
pudo	p u d o
pueblo	p w e b l o
pueda	p w e D a
puede	p w e d e
puedes	p w e d e s
puedo	p w e D o
puente	p w e n t e
puercoespines	p w e r k o e s p i n e s
puerro	p w e r o
puerta	p w e r t a
puerto	p w e r t o
pues	p w e s
puesto	p w e s t o
pujar	p u x a 4
pulmón	p u l m o n
pulpa	p u l p a
pulpo	p u l p o
puma	p u m a
puna	p u n a
punta	p u n t a
puntada	p u n t a d a
puntilla	p u n t i L a
puntillo	p u n t i L o
purgatorio	p u 4 G a t o 4 i o
puse	p u s e
puso	p u s o
puya	p u J\j\ a
puzzle	p u s l e
puño	p u J o
pyme	p i m e
pádel	p a d e l
página	p a x i n a
pájaro	p a x a 4 o
páramo	p a 4 a m o
párpado	p a 4 p a D o
párrafo	p a r a f o
pátina	p a t i n a
péndulo	p e n d u l o
pícaro	p i k a 4 o
pío	p i o
pórtico	p o 4 t i k o
póster	p o s t e 4
púa	p u a
púbico	p u b i k o
público	p u B l i k o
púlpito	p u l p i t o
q	k
que	k e
quehacer	k e a T e 4
queja	k e x a
quejar	k e x a 4
quepo	k e p o
queque	k e k e
querella	k e 4 e L a
querencia	k e r e n T j a
querer	k e 4 e 4
queso	k e s o
quien	k j e n
quienes	k j e n e s
quiere	k j e 4 e
quiero	k j e r o
quimera	k i m e 4 a
quina	k i n a
quince	k i n T e
quinceañera	k i n T e a J e 4 a
quincena	k i n T e n a
quinientos	k i n j e n t o s
quinquenal	k i N k e n a l
quinto	k i n t o
quiosco	k j o h k o
quise	k i s e
quiso	k i s o
quisquilloso	k i s k i L o s o
quitar	k i t a 4
quito	k i t o
quiz	k w i T
quizá	k i T a
quizás	k i T a s
quién	k j e n
qué	k e
quórum	k w o 4 u m
r	4
rabia	r a B j a
rabiar	r a B j a 4
racimo	r a T i m o
racista	r a T i s t a
radial	r a d j a l
radio	r a D j o
rai	r a i
raja	r a x a
rajar	r a x a 4
raje	r a x e
ralea	r a l e a
ramo	r a m o
rancio	r a n T j o
rape	r a p e
rapidísimo	r a p i d i s i m o
rapsodia	r a p s o D j a
rascar	r a s k a 4
rasgo	r a z G o
rastrojo	r a s t r o x o
ratito	r a t i t o
rato	r a t o
raza	r a T a
razonar	r a T o n a 4
razón	r a s o n
raíz	r a i T
reafirmación	r e a f i 4 m a T j o N
rebaño	r e b a J o
rebelde	r e b e l d e
rebelión	r e b e l j o n
recado	r e k a d o
recibir	r e T i b i 4
recinto	r e s i n t o
recio	r e T j o
recluta	r e k l u t a
reconocer	r e k o n o d s e 4
recordar	r e k o r d a 4
recular	r e k u l a 4
red	r e d
redacción	r e D a k T j o n
redactor	r e d a g t o 4
redactora	r e d a g t o 4 a
redondo	r e d o n d o
reduces	r e d u T e s
reemplazar	r e e m p l a T a r
referencia	r e f e 4 e n T j a
referencias	4 e f e 4 e n T j a s
reflejo	r e f l e x o
refrigerio	r e f 4 i x e 4 j o
regalar	r e g a l a 4
regalo	r e g a l o
regañar	r e_~ g a J a 4
regaño	r e g a J o
regente	r e x e n t e
relatividad	r e l a t i b i d a d
relativo	r e l a t i b o
relato	4 e l a t o
religiosidad	r e l i x j o s i d a d
reliquia	r e l i k j a
reloj	r e l o x
remitente	r e m i t e n t e
remoción	r e m o T j o n
remontada	r e m o n t a d a
remover	r e m o b e 4
renglón	r e n g l o n
reno	r e n o
renombre	r e n o m b 4 e
renovación	r e n o b a T j o n
rentabilidad	r e n t a B i l i D a D
rente	r e n t e
reparar	r e p a 4 a 4
repechaje	r e p e t S a x e
repente	r e p e n t e
repentino	r e p e n t i n o
repito	r e p i t o
repliegue	r e p l j e g e
república	r e p u B l i k a
requesón	r e k e s o n
requetebién	r e k e t e B j e n
requisito	r e k i s i t o
reservar	r e s e r b a 4
resina	r e s i n a
resistente	r e s i s t e n t e
restablecer	r e s t a b l e T e 4
reunir	r e u n i 4
reutilizar	r e u t i l i T a 4 r e u t i l i T a 4
revelar	r e B e l a 4
revolucionario	r e B o l u T i o n a 4 i o
revés	r e b e s
rey	r e i
ridiculizar	r i d i k u l i T a 4
rincón	r i_~ N k o_~ n
rinoceronte	r i n o T e 4 o n t e
rio	r j o
risa	r i s a
ritmo	r i t m o
robar	r o b a 4
roble	r o B l e
robo	r o b o
rocanrolero	r o k a n r o l e 4 o
rociar	r o T i a 4
rock	r o k
rocola	r o k o l a
rocoso	r o k o s o
rodilla	r o d i L a
roedor	r o e d o 4
roja	r o x a
rojas	r o x a s
rojo	r o x o
rojos	r o x o s
rombo	r o m b o
romo	r o m o
rompe	r o m p e
ropa	r o p a
rosa	r o s a
rosal	r o s a l
rosaleda	r o s a l e d a
roto	r o t o
roya	r o J\j\ a
rozón	r o T o n
rubia	r u b i a
rubio	r u b j o
rubí	r u B i
rudo	r u d o
rueda	r w e D a
ruge	r u x e
rugir	r u x i 4
ruido	r w i d o
ruin	r w j n
ruleta	r u l e t a
rumana	4 u m a n a
rumano	r u m a n o
runa	r u n a
rupestre	r u p e s t 4 e
rusa	r u s a
ruso	r u s o
rédito	r e D i t o
régimen	r e x i m e n
ríen	r i e n
rígida	r i x i d a
río	r i o
s	s
sabana	s a B a n a
sabe	s a b e
saben	s a B e n
saber	s a b e 4
sabes	s a b e s
sabihondo	s a b i o n d o
sabio	s a b j o
sabor	s a b o 4
saborear	s a B o 4 e a 4
sabéis	s a b e i s
sabés	s a b e s
saca	s a k a
sacapuntas	s a k a p u n t a s
sacar	s a k a 4
sacramento	s a k 4 a m e n t o
sacramentos	s a k 4 a m e_~ n t o s
sacristán	s a k 4 i s t a n
saja	s a x a
sake	s a k e
sal	s a l
salario	s a l a 4 j o
sale	s a l e
sales	s a l e s
salir	s a l i 4
saliva	s a l i B a
salmo	s a l m o
salmón	s a l m o n
salpicar	s a l p i k a 4
salsa	s a l s a
saludo	s a l u d o
sambódromo	s a m b o d 4 o m o
samurái	s a m u 4 a i
san	s a n
sana	s a n a
sancho	s a n tS o
sancionar	s a n T j o n a 4
sandwich	s a n g w i tS
sangre	s a n g r e
sangría	s a n g 4 i a
santa	s a n t a
santafesino	s a n t a f e s i n o
santo	s a n t o
sapa	s a p a
sapiencia	s a p j e n T j a
saque	s a k e
saqué	s a k e
sarampión	s a 4 a m p j o n
sarcasmo	s a r k a s m o
sargento	s a 4 x e n t o
sarmiento	s a r m j e n t o
satélite	s a t e l i t e
sayonara	s a J\j\ o n a 4 a
se	s e
sea	s e a
sean	s e a n
seas	s e a s
seco	s e k o
secreto	s e k r e t o
sed	s e D
seda	s e d a
sede	s e d e
seducir	s e D u s i 4
segregar	s e G 4 e G a 4
seguidilla	s e g i d i L a
seguir	s e g i 4
seguro	s e g u 4 o
seis	s e i s
seiscientos	s e i s T j e n t o s
selva	s e l B a
semana	s e m a n a
semanario	s e m a n a 4 j o
semanas	s e m a n a s
semáforo	s e m a f o 4 o
semántico	s e m a n t i k o
senado	s e n a d o
senador	s e n a d o 4
sencillo	s e n T i L o
senda	s e n d a
sendos	s e n d o s
seno	s e n o
sentado	s e n t a D o
sentar	s e n t a 4
sentenciar	s e n t e n T j a 4
sentimental	s e n t i m e n t a l
sentir	s e n t i 4
separador	s e p a 4 a D o 4
sepultar	s e p u l t a 4
ser	s e 4
serafín	s e 4 a f i n
serie	s e 4 i e
serigrafía	s e 4 i g 4 a f i a
serio	s e 4 j o
serrucho	s e r u tS o
servicio	s e r b i T j o
servidumbre	s e 4 B i D u m b 4 e
será	s e 4 a
seré	s e 4 e
sesenta	s e s e n t a
seta	s e t a
setenta	s e t e n t a
sevillano	s e b i L a n o
sexto	s e k s t o
sexual	s e k s u a l
sexualidad	s e k s w a l i D a d
señal	s e J a l
señalar	s e J a l a 4
señor	s e J o 4
señora	s e J o 4 a
señorita	s e J o 4 i t a
señorío	s e J o 4 i o
sheriff	S e 4 i f
shiitake	s i t a k e
si	s i
sicario	s i k a 4 j o
sideral	s i D e 4 a l
siempre	s j e m p 4 e
sierra	s j e r a
siervo	s j e 4 B o
siesta	s j e s t a
siete	s j e t e
siga	s i g a
siglo	s i g l o
sigue	s i g e
sigues	s i g e s
siguiente	s i G j e n t e
sij	s i x
silicio	s i l i T j o
silla	s i L a
sillón	s i L o n
silo	s i l o
silueta	s i l w e t a
sima	s i m a
similar	s i m i l a 4
simple	s i m p l e
simplón	s i m p l o n
simposio	s i m p o s j o
simpático	s i m p a t i k o
simulacro	s i m u l a k 4 o
sin	s i n
sinagoga	s i n a G o G a
sinaloense	s i n a l o e n s e
sincero	s i n T e 4 o
sindicalizar	s i n d i k a l i T a 4
sinfonía	s i F f o n i a
sino	s i n o
sintaxis	s i n t a k s i s
sintético	s i n t e t i k o
sinvergüenza	s i m b e 4 g w e n T a
sinónimo	s i n o n i m o
sinónimos	s i n o n i m o s
sioux	s j u k s
sipi	s i p i
siquiera	s i k j e 4 a
sirena	s i 4 e n a
sismo	s i z m o
sistema	s i s t e m a
sobaco	s o B a k o
sobre	s o b 4 e
sobremesa	s o B 4 e m e s a
sobriedad	s o B 4 j e D a D
sobrino	s o b 4 i n o
socarrat	s o k a r a t
social	s o T i a l
sociólogo	s o T j o l o M\ o
software	s o f w e 4
sofá	s o f a
sois	s o i s
soja	s o x a
sol	s o l
solamente	s o l a m e_~ n t e
soldado	s o l d a d o
solidaridad	s o l i d a 4 i d a d
solidario	s o l i d a 4 j o
solista	s o l i s t a
solo	s o l o
solía	s o l i a
son	s o n
sonrisa	s o_~ n r i s a
soplón	s o p l o n
sorbete	s o 4 b e t e
sorpresa	s o r p 4 e s a
sostén	s o s t e n
sotavento	s o t a b e n t o
soy	s o i
soñar	s o J a 4
stá	s t a
su	s u
suave	s w a B e
subdivide	s u B D i B i D e
subnormal	s u b n o r m a l
subterráneo	s u B t e r a n e o
sucio	s u T j o
sucursal	s u k u 4 s a l
suda	s u d a
sudan	s u D a n
sudanesa	s u d a n e s a
sudanesas	s u d a n e s a s
sudo	s u d o
sudoku	s u D o k u
sudor	s u D o 4
suegra	s w e g 4 a
suela	s w e l a
suele	s w e l e
suelto	s w e l t o
suerte	s w e 4 t e
sueño	s w e J o
sufijo	s u f i x o
sujetar	s u x e t a 4
sujeto	s u x e t o
sulfuro	s u l f u 4 o
sultán	s u l t a n
sumo	s u m o
sunita	s u n i t a
suní	s u n i
supe	s u p e
supermercado	s u p e 4 m e 4 k a d o
supermán	s u p e 4 m a n
supersónico	s u p e 4 s o n i k o
suplicio	s u p l i T j o
supo	s u p o
surf	s u 4 f
surtidor	s u r t i d o 4
sus	s u s
susceptible	s u s T e b t i b l e
suscriptor	s u s k 4 i b t o 4
sushi	s u S i
suspender	s u s p e n d e r
suspendido	s u s p e n d i d o
sustancia	s u s t a n T j a
sustancial	s u s t a n T j a l
sutil	s u t i l
suya	s u j a
suyas	s u j a s
suyo	s u j\ o
suyos	s u j o s
suástica	s w a s t i k a
sábado	s a b a d o
sábana	s a B a n a
sácate	s a k a t e
sándwich	s a n g w i tS
sánscrito	s a n s k 4 i t o
sé	s e
séquito	s e k i t o
sésamo	s e s a m o
sí	s i
síes	s i e s
símbolo	s i m b o l o
símiles	s i m i l e s
síndico	s i n d i k o
sínodo	s i n o D o
síntesis	s i n t e s i s
sólido	s o l i D o
sónico	s o n i k o
t	t
tabique	t a b i k e
tabú	t a B u
taco	t a k o
tacón	t a k o n
taekwondo	t a j k o n d o
tajo	t a x o
tal	t a l
tala	t a l a
talar	t a l a 4
tallar	t a L a 4
taller	t a L e 4
tallo	t a L o
talud	t a l u D
talvez	t a l b e T
tamagochi	t a m a g o tS i
tamaño	t a m a J o
también	t a m b j e n
tambor	t a m B o 4
tampoco	t a m p o k o
tanga	t a N g a
tapacubos	t a p a k u B o s
tardísimo	t a 4 d i s i m o
tarifa	t a 4 i f a
tarima	t a 4 i m a
tarjeta	t a 4 x e t a
tarraconense	t a r a k o n e n s e
tartera	t a 4 t e 4 a
tasa	t a s a
tasar	t a s a 4
tatami	t a t a m i
tauromaquia	t a u 4 o m a k j a
taza	t a T a
te	t e
tea	t e a
tebeo	t e B e o
tecito	t e T i t o
tecla	t e k l a
teclear	t e k l e a 4
teja	t e x a
tejo	t e x o
tela	t e l a
telaraña	t e l a 4 a J a
telefonía	t e l e f o n i a
telepatía	t e l e p a t i a
teléfono	t e l e f o n o
tema	t e m a
temblor	t e m b l o 4
tempestad	t e m p e s t a D
templanza	t e m p l a n T a
templo	t e m p l o
temporada	t e m p o 4 a d a
temprano	t e m p 4 a n o
tempura	t e m p u 4 a
ten	t e n
tenacidad	t e n a T i D a D
tenaz	t e n a T
tendente	t e n d e n t e
tener	t e n e 4
teniente	t e n j e n t e
tenista	t e n i s t a
tentación	t e n t a s j o n
tentador	t e n t a D o 4
tentar	t e n t a 4
teocracia	t e o k r a T j a
teología	t e o l o i a
teoría	t e o 4 i a
tequila	t e k i l a
terapia	t e 4 a p j a
terapéutico	t e 4 a p e u t i k o
terciopelo	t e 4 T j o p e l o
terco	t e r k o
termo	t e 4 m o
terracota	t e r a k o t a
terrestre	t e r e s t 4 e
tertulia	t e 4 t u l j a
tes	t e s
tesorero	t e s o 4 e 4 o
tesoro	t e s o 4 o
testicular	t e s t i k u l a 4
testigo	t e s t i g o
teta	t e t a
tete	t e t e
textil	t e k s t i l
tez	t e T
teísmo	t e i s m o
teísta	t e i s t a
teórico	t e o 4 i k o
ti	t i
tianguis	t j a n g i s
tiara	t j a 4 a
tiburón	t i B u 4 o n
tiempo	t j e m p o
tienda	t j e n d a
tierra	t j e r a
tifus	t i f u s
tifón	t i f o n
tigre	t i g 4 e
tijera	t i x e 4 a
timar	t i m a 4
timbre	t i m b 4 e
timo	t i m o
timón	t i m o n
tinieblas	t i n j e b l a s
tinta	t i n t a
tira	t i 4 a
tirar	t i 4 a 4
tire	t i 4 e
tirita	t i 4 i t a
titanio	t i t a n j o
titubear	t i t u B e a 4
tiza	t i T a
tizón	t i T o n
tlacuache	t K a k w a t S e
toalla	t o a L a
toallas	t o a L a s
tobillo	t o B i L o
tobogán	t o b o g a n
tocar	t o k a 4
tocayo	t o k a j\ o
tocho	t o t S o
toda	t o d a
todas	t o d a s
todavía	t o d a b i a
todo	t o D o
todos	t o d o s
tolerante	t o l e 4 a n t e
tolerantes	t o l e 4 a n t e s
tolerar	t o l e 4 a 4
tomate	t o m a t e
tomo	t o m o
tomos	t o m o s
tonga	t o n g a
tonos	t o n o s
tonto	t o n t o
topo	t o p o
topografía	t o p o G 4 a f i a
toque	t o k e
torbellino	t o r b e L i n o
tordo	t o r d o
torero	t o 4 e 4 o
tornado	t o 4 n a D o
tornasol	t o 4 n a s o l
toro	t o 4 o
torso	t o 4 s o
tortilla	t o 4 t i L a
tortuoso	t o 4 t w o s o
tosca	t o s k a
tostón	t o s t o n
tour	t u 4
trabajar	t 4 a b a x a 4
trabajo	t 4 a B a x o
trabajábamos	t 4 a B a x a B a m o s
tradición	t 4 a d i T j o n
traducción	t 4 a D u k T j o n
traduce	t 4 a D u T e
traducen	t 4 a d u T e n
traducir	t 4 a d u T i 4
tradujiste	t 4 a d u x i s t e
traduzca	t 4 a d u T k a
traer	t 4 a e 4
tragedia	t 4 a x e D j a
traición	t 4 a j T j o n
traje	t 4 a x e
trama	t 4 a m a
tramite	t r a m i t e
trampolín	t 4 a m p o l i n
tranquilo	t r a N k i l o
trapo	t 4 a p o
trasero	t 4 a s e 4 o
trasgo	t 4 a s g o
traslado	t 4 a s l a d o
trasnochar	t r a s n o tS a r
trasplantar	t 4 a s p l a n t a 4
trastorno	t 4 a s t o r n o
tratar	t 4 a t a 4
trauma	t 4 a w m a
traumatizante	t 4 a u m a t i T a n t e
traumático	t 4 a u m a t i k o
trazo	t r a s o
trece	t 4 e T e
tregua	t 4 e g w a
treinta	t 4 e i n t a
trenza	t 4 e n T a
tres	t 4 e s
trescientos	t 4 e s T j e n t o s
treta	t 4 e t a
trillón	t 4 i L o n
trofeo	t 4 o f e o
trolebús	t r o l e b u s
trompa	t 4 o m p a
tronco	t 4 o N k o
tropa	t 4 o p a
tropel	t 4 o p e l
tropezar	t 4 o p e T a 4
tropical	t 4 o p i k a l
trotar	t 4 o t a 4
troy	t 4 o i
truco	t 4 u k o
truquito	t 4 u k i t o
trágico	t 4 a x i k o
trámite	t r a m i t e
trébol	t 4 e B o l
tríptico	t 4 i p t i k o
trópico	t 4 o p i k o
tsunami	s u n a m i
tu	t u
tubo	t u b o
tuitero	t w i t e 4 o
tule	t u l e
tulipán	t u l i p a n
turco	t u 4 k o
tus	t u s
tutor	t u t o 4
tuvo	t u b o
tuya	t u j\ a
tuyas	t u j a s
tuyo	t u j o
tuyos	t u j o s
tv	t e B e
tártaro	t a r t a 4 o
té	t e
técnico	t e k n i k o
térmico	t e r m i k o
término	t e r m i n o
tétanos	t e t a n o s
tía	t i a
tío	t i o
título	t i t u l o
tóner	t o n e 4
tótem	t o t e m
tóxico	t o k s i k o
tú	t u
túnel	t u n e l
u	u
ubicar	u b i k a 4
ufano	u f a n o
uh	u
ultrajar	u l t 4 a x a 4
un	u n
una	u n a
unas	u n a s
unes	u n e s
uni	u n i
unicameral	u n i k a m e 4 a l
unicornio	u n i k o 4 n j o
universo	u n i b e r s o
unión	u n j o n
uno	u n o
uní	u n i
unísono	u n i s o n o
uranio	u 4 a n j o
urbe	u r b e
urdimbre	u 4 D i m b 4 e
urdu	u r d u
urea	u 4 e a
urna	u r n a
uro	u 4 o
urraca	u r a k a
uso	u s o
usos	u s o s
usted	u s t e D
ustedes	u s t e d e s
usurpar	u s u 4 p a 4
utilidad	u t i l i d a d
utopia	u t o p j a
utopía	u t o p i a
uva	u b a
uy	u j
uña	u J a
v	b
vaca	b a k a
vacación	B a k a T j o n
vacuna	b a k u n a
vagabundo	b a g a b u n d o
vagina	b a x i n a
vagón	b a G o n
vaina	b a i n a
vainilla	b a i n i j\ a
vainillas	B a I n i L a s
vajilla	b a x i L a
val	b a l
valle	b a L e
valor	B a l o 4
valoración	b a l o 4 a T j o n
vamos	b a m o s
van	b a n
vanidoso	b a n i D o s o
vapor	b a p o 4
varones	b a 4 o n e s
varonil	b a 4 o n i l
varón	b a 4 o n
vas	b a s
vaso	b a s o
ve	b e
vecina	b e s i n a
vecindad	B e T i n d a D
vecino	b e s i n o
vegano	b e g a n o
vehemencia	b e m e n T j a
veinte	b e i n t e
veinticinco	b e i n t i T i n k o
veinticuatro	b e i n t i k w a t 4 o
veintidós	b e i n t i d o s
veintiocho	b e i n t j o tS o
veintisiete	b e i n t i s j e t e
veintiséis	b e i n t i s e i s
veintitrés	b e i n t i t 4 e s
vejez	b e X e T
vejiga	b e x i G a
vela	b e l a
velas	B e l a s
veleta	b e l e t a
velo	b e l o
vena	b e n a
venado	b e n a D o
venal	b e n a l
vencer	b e n T e 4
venda	B e n d a
vender	b e n d e r
vendimia	b e n d i m j a
vendo	B e n d o
venganza	b e N g a n T a
vengo	b e n g o
venia	b e n i a
vente	B e n t e
vera	b e 4 a
veracidad	b e 4 a T i D a D
verano	b e 4 a n o
veras	b e 4 a s
veraz	b e 4 a T
verbal	b e r b a l
verbena	b e r b e n a
verdad	b e 4 D a D
verde	b e r d e
verdura	b e 4 D u 4 a
verga	b e 4 G a
vergonzoso	b e 4 G o n s o s o
vergüenza	b e r g w e n T a
versión	b e 4 s j o_~ n
versus	b e r s u s
ves	b e s
vez	b e T
viaje	b j a x e
viciosa	b i T j o s a
viciosos	b i T j o s o s
victoria	b i k t o 4 i a
victorioso	b i g t o 4 j o s o
vicuña	b i k u J a
vid	b i D
vida	b i D a
video	b i d e o
videovigilancia	b i d e o b i x i l a n T j a
vidrio	b i D 4 i o
viejo	b j e x o
viene	b j e n e
viento	b j e n t o
viernes	b j e r n e s
viga	b i g a
vigilia	b i x i l j a
vigésimo	b i x e s i m o
villancico	b i L a n T i k o
vinculación	b i n k u l a T i o n
vine	b i n e
vino	b i n o
vinícola	b i n i k o l a
violencia	b j o l e n T j a
violeta	b j o l e t a
virgen	b i 4 x e n
virginidad	b i 4 x i n i D a D
viril	b i 4 i l
viriles	b i 4 i l e s
virtud	b i 4 t u D
viruela	b i 4 w e l a
visco	b i s k o
visita	b i s i t a
visitar	b i s i t a 4
vista	b i s t a
viste	B i s t e
viticultura	b i t i k u l t u 4 a
vivero	b i B e 4 o
vivienda	b i b j e n d a
vivir	b i b i 4
viña	b i J a
viñedo	b i J e D o
vocablo	b o k a B l o
vocacional	b o k a T j o_~ n a l
voces	b o T e s
vodka	b o D k a
volar	b o l a 4
volcánico	b o l k a n i k o
voleibol	b o l e i B o l
volver	b o l b e 4
voraz	B o 4 a T
vorágine	b o 4 a X i n e
vos	b o s
vosotras	b o s o t 4 a s
vosotros	b o s o t 4 o s
votar	b o t a 4
voy	b o i
voz	b o T
vuelo	B w e l o
vuelto	b w e l t o
vuelvo	b w e l b o
vuestra	b w e s t 4 a
vuestras	b w e s t 4 a s
vuestro	B w e s t 4 o
vuestros	b w e s t 4 o s
vulgar	b u l g a 4
vulnerable	b u l n e 4 a b l e
vuélvete	b w e l b e t e
válvula	b a l b u l a
vámonos	b a m o n o s
vértebra	b e 4 t e b 4 a
vértice	b e 4 t i T e
vía	b i a
víbora	b i B o 4 a
vídeo	b i d e o
víspera	b i s p e 4 a
w	w
walkman	w a k m a n
watt	w a t
we	w e
web	w e b
wey	w e i
whisky	g w i s k i
wifi	w i f i
wiki	w i k i
x	k s
xenofobia	s e n o f o B j a
xenófobo	s e n o f o b o
xenón	s e n o n
y	i
ya	J\j\ a
yacer	j\ a T e 4
yanqui	J\j\ a n k i
yate	j\ a t e
yayo	J\j\ a J\j\ o
ye	J\j\ e
yegua	J\j\ e g w a
yen	j e n
yerba	J\j\ e r b a
yerno	j\ e 4 n o
yes	J\j\ e s
yeso	J\j\ e s o
yihad	j\ i a D j\ i x a D
yihadista	J\j\ i x a d i s t a
yo	j\ o
yodo	j\ o D o
yugo	j\ u g o
z	s E t a
zafiro	T a f i 4 o
zancudo	T a n k u d o
zapato	T a p a t o
zapping	T a p i n
zarza	T a r T a
zeta	T e t a
zetas	T e t a s
zodiaco	T o D j a k o
zombi	T o m b i
zona	T o n a
zoo	T o
zoológico	T o o l o x i c o
zorro	T o r o
zulú	T u l u
zumo	T u m o
ábaco	a b a k o
ácaro	a k a 4 o
ácido	a T i d o
ácrata	a k 4 a t a
ágora	a g o 4 a
águila	a G i l a
álbum	a l B u m
ámbar	a m b a 4
ánade	a n a D e
ángel	a n x e l
ángelus	a N x e l u s
ánima	a n i m a
ánimo	a n i m o
ápice	a p i T e
árabe	a 4 a B e
árbol	a 4 b o l
átomo	a t o m o
él	e l
énfasis	e F f a s i s
épica	e p i k a
épico	e p i k o
ético	e t i k o
éxtasis	e k s t a s i s
ícono	i k o n o
íes	i e s
ímpetu	i m p e t u
índico	i n d i k o
ínfimo	i n f i m o
ítem	i t e m
ñ	e J e
ñoquis	J o k i s
ó	o
óleo	o l e o
ónix	o n i k s
ópera	o p e 4 a
órgano	o 4 G a n o
óseo	o s e o
útil	u t i l
ü	w
